"統計年月","縣市","行政區域","出生數","出生數.男","出生數.女","死亡數","死亡數.男","死亡數.女","結婚對數","離婚對數"
10401,"高雄市","阿蓮區阿蓮里",12,7,5,10,8,2,10,3
10401,"高雄市","阿蓮區峯山里",1,1,0,3,2,1,0,0
10401,"高雄市","阿蓮區復安里",3,0,3,4,0,4,1,0
10401,"高雄市","阿蓮區崗山里",1,0,1,0,0,0,2,0
10401,"高雄市","阿蓮區港後里",0,0,0,1,0,1,7,1
10401,"高雄市","阿蓮區和蓮里",3,3,0,2,1,1,1,0
10401,"高雄市","阿蓮區南蓮里",5,2,3,7,6,1,6,1
10401,"高雄市","阿蓮區青旗里",0,0,0,3,1,2,1,0
10401,"高雄市","阿蓮區清蓮里",3,2,1,6,5,1,1,1
10401,"高雄市","阿蓮區石安里",0,0,0,0,0,0,4,1
10401,"高雄市","阿蓮區玉庫里",3,2,1,2,1,1,3,0
10401,"高雄市","阿蓮區中路里",3,2,1,6,3,3,0,0
10401,"高雄市","大寮區潮寮里",6,4,2,7,2,5,2,2
10401,"高雄市","大寮區大寮里",2,1,1,9,7,2,8,0
10401,"高雄市","大寮區光武里",0,0,0,0,0,0,1,0
10401,"高雄市","大寮區過溪里",4,2,2,2,1,1,6,0
10401,"高雄市","大寮區後庄里",10,2,8,9,4,5,18,3
10401,"高雄市","大寮區會結里",0,0,0,3,2,1,2,1
10401,"高雄市","大寮區會社里",9,4,5,9,8,1,13,5
10401,"高雄市","大寮區江山里",3,2,1,4,2,2,5,0
10401,"高雄市","大寮區拷潭里",0,0,0,0,0,0,1,1
10401,"高雄市","大寮區琉球里",7,3,4,7,4,3,8,2
10401,"高雄市","大寮區內坑里",18,9,9,7,5,2,4,6
10401,"高雄市","大寮區前庄里",3,2,1,5,3,2,2,0
10401,"高雄市","大寮區三隆里",12,7,5,11,5,6,6,4
10401,"高雄市","大寮區山頂里",18,6,12,16,8,8,8,2
10401,"高雄市","大寮區上寮里",3,0,3,3,2,1,1,0
10401,"高雄市","大寮區翁園里",2,0,2,6,4,2,7,0
10401,"高雄市","大寮區溪寮里",2,1,1,3,3,0,1,0
10401,"高雄市","大寮區新厝里",2,1,1,2,2,0,5,2
10401,"高雄市","大寮區義和里",1,0,1,3,2,1,4,1
10401,"高雄市","大寮區義仁里",0,0,0,4,3,1,1,2
10401,"高雄市","大寮區永芳里",12,5,7,10,7,3,11,2
10401,"高雄市","大寮區昭明里",2,2,0,4,4,0,7,2
10401,"高雄市","大寮區中興里",5,4,1,7,6,1,5,4
10401,"高雄市","大寮區中庄里",25,14,11,8,4,4,11,4
10401,"高雄市","大寮區忠義里",2,1,1,2,2,0,0,0
10401,"高雄市","大社區保安里",7,3,4,2,2,0,3,0
10401,"高雄市","大社區保社里",3,1,2,6,5,1,2,1
10401,"高雄市","大社區翠屏里",2,2,0,2,2,0,4,1
10401,"高雄市","大社區大社里",12,5,7,4,2,2,5,2
10401,"高雄市","大社區觀音里",7,4,3,3,3,0,7,0
10401,"高雄市","大社區嘉誠里",2,0,2,6,4,2,0,1
10401,"高雄市","大社區三奶里",4,1,3,6,5,1,4,1
10401,"高雄市","大社區神農里",6,5,1,5,2,3,7,3
10401,"高雄市","大社區中里里",1,1,0,5,5,0,6,3
10401,"高雄市","大樹區大坑里",2,1,1,2,2,0,2,0
10401,"高雄市","大樹區大樹里",1,1,0,2,0,2,3,1
10401,"高雄市","大樹區姑山里",3,1,2,4,4,0,2,0
10401,"高雄市","大樹區和山里",1,0,1,3,2,1,0,0
10401,"高雄市","大樹區井腳里",1,1,0,9,4,5,0,0
10401,"高雄市","大樹區九曲里",9,4,5,3,2,1,4,1
10401,"高雄市","大樹區久堂里",3,2,1,6,5,1,3,2
10401,"高雄市","大樹區龍目里",1,1,0,0,0,0,3,0
10401,"高雄市","大樹區三和里",1,0,1,2,1,1,0,0
10401,"高雄市","大樹區檨腳里",5,4,1,7,6,1,1,1
10401,"高雄市","大樹區水安里",3,3,0,4,3,1,2,1
10401,"高雄市","大樹區水寮里",3,1,2,4,2,2,1,0
10401,"高雄市","大樹區統嶺里",0,0,0,1,1,0,1,0
10401,"高雄市","大樹區溪埔里",3,1,2,0,0,0,4,0
10401,"高雄市","大樹區小坪里",3,2,1,3,3,0,1,1
10401,"高雄市","大樹區興山里",1,1,0,3,2,1,1,0
10401,"高雄市","大樹區興田里",1,0,1,6,2,4,4,1
10401,"高雄市","大樹區竹寮里",4,2,2,0,0,0,3,0
10401,"高雄市","鳳山區保安里",11,4,7,3,3,0,9,0
10401,"高雄市","鳳山區北門里",4,3,1,11,7,4,4,1
10401,"高雄市","鳳山區曹公里",2,1,1,6,3,3,4,1
10401,"高雄市","鳳山區成功里",2,2,0,4,3,1,1,0
10401,"高雄市","鳳山區誠德里",2,2,0,2,1,1,2,1
10401,"高雄市","鳳山區誠信里",3,2,1,1,0,1,6,1
10401,"高雄市","鳳山區誠義里",8,5,3,2,2,0,1,1
10401,"高雄市","鳳山區誠智里",4,1,3,2,1,1,1,3
10401,"高雄市","鳳山區大德里",2,1,1,1,1,0,15,3
10401,"高雄市","鳳山區東門里",7,3,4,7,2,5,4,1
10401,"高雄市","鳳山區二甲里",12,7,5,1,0,1,6,2
10401,"高雄市","鳳山區鳳東里",7,5,2,8,7,1,11,4
10401,"高雄市","鳳山區鳳崗里",1,1,0,3,2,1,1,1
10401,"高雄市","鳳山區福誠里",4,0,4,7,4,3,6,5
10401,"高雄市","鳳山區福祥里",3,2,1,3,2,1,5,1
10401,"高雄市","鳳山區福興里",14,9,5,4,3,1,9,4
10401,"高雄市","鳳山區富甲里",4,3,1,8,5,3,2,0
10401,"高雄市","鳳山區富榮里",7,5,2,1,1,0,4,2
10401,"高雄市","鳳山區光明里",2,2,0,1,1,0,2,0
10401,"高雄市","鳳山區國富里",2,2,0,2,0,2,3,2
10401,"高雄市","鳳山區國光里",3,1,2,2,0,2,3,0
10401,"高雄市","鳳山區國隆里",2,1,1,1,0,1,2,2
10401,"高雄市","鳳山區國泰里",4,2,2,3,2,1,8,0
10401,"高雄市","鳳山區過埤里",40,20,20,7,6,1,27,6
10401,"高雄市","鳳山區海光里",4,0,4,7,3,4,4,2
10401,"高雄市","鳳山區海洋里",5,5,0,0,0,0,5,2
10401,"高雄市","鳳山區和德里",2,1,1,4,3,1,4,0
10401,"高雄市","鳳山區和興里",9,6,3,2,2,0,1,4
10401,"高雄市","鳳山區老爺里",10,4,6,7,4,3,9,4
10401,"高雄市","鳳山區龍成里",5,3,2,2,2,0,4,2
10401,"高雄市","鳳山區南成里",8,1,7,7,4,3,8,1
10401,"高雄市","鳳山區南和里",5,1,4,2,1,1,6,0
10401,"高雄市","鳳山區南興里",1,1,0,1,1,0,1,1
10401,"高雄市","鳳山區埤頂里",7,3,4,8,6,2,9,2
10401,"高雄市","鳳山區瑞興里",6,3,3,1,1,0,4,1
10401,"高雄市","鳳山區瑞竹里",5,3,2,9,3,6,11,3
10401,"高雄市","鳳山區三民里",1,0,1,1,1,0,2,1
10401,"高雄市","鳳山區善美里",11,4,7,7,5,2,8,2
10401,"高雄市","鳳山區生明里",1,0,1,1,0,1,3,1
10401,"高雄市","鳳山區天興里",6,3,3,2,1,1,4,1
10401,"高雄市","鳳山區文德里",13,6,7,5,2,3,13,4
10401,"高雄市","鳳山區文福里",8,5,3,6,4,2,17,4
10401,"高雄市","鳳山區文衡里",12,3,9,2,0,2,9,0
10401,"高雄市","鳳山區文華里",8,3,5,13,8,5,11,0
10401,"高雄市","鳳山區文山里",5,2,3,6,5,1,14,5
10401,"高雄市","鳳山區文英里",3,1,2,5,4,1,4,0
10401,"高雄市","鳳山區五福里",4,2,2,3,2,1,3,1
10401,"高雄市","鳳山區武漢里",7,1,6,3,1,2,8,1
10401,"高雄市","鳳山區武慶里",4,1,3,2,1,1,3,0
10401,"高雄市","鳳山區武松里",3,1,2,0,0,0,2,2
10401,"高雄市","鳳山區縣口里",0,0,0,0,0,0,2,0
10401,"高雄市","鳳山區縣衙里",0,0,0,0,0,0,2,0
10401,"高雄市","鳳山區協和里",7,4,3,9,5,4,2,2
10401,"高雄市","鳳山區新富里",3,1,2,4,4,0,6,3
10401,"高雄市","鳳山區新甲里",2,0,2,6,5,1,3,1
10401,"高雄市","鳳山區新樂里",11,6,5,2,2,0,6,2
10401,"高雄市","鳳山區新強里",7,3,4,3,1,2,6,1
10401,"高雄市","鳳山區新泰里",4,2,2,0,0,0,2,2
10401,"高雄市","鳳山區新武里",3,0,3,3,1,2,2,1
10401,"高雄市","鳳山區新興里",1,1,0,7,6,1,2,2
10401,"高雄市","鳳山區興仁里",2,2,0,8,6,2,6,0
10401,"高雄市","鳳山區興中里",1,1,0,4,1,3,1,0
10401,"高雄市","鳳山區一甲里",4,4,0,3,3,0,2,4
10401,"高雄市","鳳山區鎮北里",19,11,8,9,6,3,14,3
10401,"高雄市","鳳山區鎮東里",3,2,1,3,1,2,3,2
10401,"高雄市","鳳山區鎮南里",6,4,2,5,1,4,7,7
10401,"高雄市","鳳山區鎮西里",6,5,1,10,6,4,4,3
10401,"高雄市","鳳山區正義里",8,6,2,10,6,4,9,1
10401,"高雄市","鳳山區中和里",1,1,0,2,1,1,6,2
10401,"高雄市","鳳山區中崙里",6,1,5,7,3,4,3,2
10401,"高雄市","鳳山區中民里",6,1,5,3,1,2,7,1
10401,"高雄市","鳳山區中榮里",8,5,3,0,0,0,7,3
10401,"高雄市","鳳山區中正里",7,2,5,13,5,8,3,1
10401,"高雄市","鳳山區忠誠里",6,4,2,4,2,2,6,0
10401,"高雄市","鳳山區忠孝里",4,1,3,5,4,1,4,1
10401,"高雄市","鳳山區忠義里",5,5,0,2,1,1,2,1
10401,"高雄市","岡山區白米里",3,1,2,1,0,1,1,0
10401,"高雄市","岡山區本洲里",3,0,3,4,3,1,1,0
10401,"高雄市","岡山區碧紅里",8,4,4,3,3,0,9,2
10401,"高雄市","岡山區程香里",2,2,0,0,0,0,7,4
10401,"高雄市","岡山區大遼里",3,1,2,1,0,1,0,3
10401,"高雄市","岡山區大莊里",2,0,2,2,1,1,1,1
10401,"高雄市","岡山區福興里",0,0,0,6,3,3,0,0
10401,"高雄市","岡山區岡山里",14,11,3,5,5,0,6,3
10401,"高雄市","岡山區和平里",0,0,0,2,1,1,0,0
10401,"高雄市","岡山區後紅里",2,1,1,2,2,0,3,2
10401,"高雄市","岡山區後協里",8,8,0,4,2,2,8,0
10401,"高雄市","岡山區華崗里",1,1,0,3,3,0,3,2
10401,"高雄市","岡山區嘉峰里",1,1,0,3,1,2,3,1
10401,"高雄市","岡山區嘉興里",5,1,4,10,7,3,2,0
10401,"高雄市","岡山區劉厝里",0,0,0,3,2,1,1,0
10401,"高雄市","岡山區平安里",3,2,1,3,1,2,0,0
10401,"高雄市","岡山區前峰里",0,0,0,5,2,3,3,2
10401,"高雄市","岡山區仁壽里",7,2,5,2,0,2,5,0
10401,"高雄市","岡山區仁義里",4,1,3,5,4,1,3,4
10401,"高雄市","岡山區三和里",0,0,0,1,0,1,0,1
10401,"高雄市","岡山區石潭里",5,2,3,3,2,1,3,0
10401,"高雄市","岡山區壽峰里",7,4,3,0,0,0,3,2
10401,"高雄市","岡山區壽天里",4,3,1,7,3,4,3,1
10401,"高雄市","岡山區台上里",13,6,7,5,3,2,13,1
10401,"高雄市","岡山區潭底里",1,1,0,4,2,2,0,0
10401,"高雄市","岡山區灣裡里",4,3,1,0,0,0,2,2
10401,"高雄市","岡山區維仁里",2,0,2,0,0,0,2,1
10401,"高雄市","岡山區為隨里",0,0,0,1,1,0,1,1
10401,"高雄市","岡山區協和里",6,4,2,6,4,2,3,3
10401,"高雄市","岡山區協榮里",4,3,1,2,2,0,3,0
10401,"高雄市","岡山區信義里",5,3,2,5,2,3,4,0
10401,"高雄市","岡山區忠孝里",6,1,5,6,6,0,2,1
10401,"高雄市","岡山區竹圍里",12,10,2,3,2,1,11,3
10401,"高雄市","鼓山區寶樹里",1,1,0,7,4,3,0,1
10401,"高雄市","鼓山區登山里",0,0,0,0,0,0,0,1
10401,"高雄市","鼓山區峰南里",1,1,0,2,1,1,1,0
10401,"高雄市","鼓山區鼓峰里",3,1,2,5,1,4,1,1
10401,"高雄市","鼓山區鼓岩里",0,0,0,1,0,1,0,0
10401,"高雄市","鼓山區光化里",2,1,1,2,0,2,3,1
10401,"高雄市","鼓山區光榮里",3,3,0,8,2,6,3,0
10401,"高雄市","鼓山區河邊里",2,1,1,2,2,0,2,0
10401,"高雄市","鼓山區厚生里",7,4,3,5,1,4,4,1
10401,"高雄市","鼓山區華豐里",2,2,0,5,3,2,3,0
10401,"高雄市","鼓山區惠安里",0,0,0,1,1,0,1,0
10401,"高雄市","鼓山區建國里",4,2,2,4,3,1,2,1
10401,"高雄市","鼓山區麗興里",0,0,0,1,0,1,3,2
10401,"高雄市","鼓山區龍井里",1,1,0,0,0,0,2,1
10401,"高雄市","鼓山區龍水里",47,28,19,16,11,5,39,5
10401,"高雄市","鼓山區龍子里",42,20,22,5,1,4,23,5
10401,"高雄市","鼓山區綠川里",2,2,0,2,2,0,5,0
10401,"高雄市","鼓山區民強里",4,2,2,4,4,0,2,1
10401,"高雄市","鼓山區民族里",2,2,0,4,4,0,3,0
10401,"高雄市","鼓山區明誠里",30,14,16,14,9,5,20,9
10401,"高雄市","鼓山區內惟里",1,1,0,3,1,2,2,0
10401,"高雄市","鼓山區平和里",8,7,1,3,2,1,4,1
10401,"高雄市","鼓山區前峰里",8,3,5,6,5,1,4,1
10401,"高雄市","鼓山區山下里",1,1,0,2,1,1,0,0
10401,"高雄市","鼓山區哨船頭里",1,0,1,1,1,0,1,0
10401,"高雄市","鼓山區壽山里",3,1,2,5,3,2,1,1
10401,"高雄市","鼓山區樹德里",1,1,0,3,2,1,1,0
10401,"高雄市","鼓山區桃源里",1,0,1,1,1,0,3,0
10401,"高雄市","鼓山區維生里",1,0,1,3,1,2,2,1
10401,"高雄市","鼓山區新民里",2,1,1,3,0,3,0,1
10401,"高雄市","鼓山區興宗里",3,2,1,4,4,0,2,0
10401,"高雄市","鼓山區雄峰里",2,0,2,5,2,3,2,1
10401,"高雄市","鼓山區延平里",2,0,2,1,0,1,0,0
10401,"高雄市","鼓山區裕豐里",3,1,2,7,2,5,5,0
10401,"高雄市","鼓山區裕興里",6,5,1,4,3,1,4,0
10401,"高雄市","鼓山區正德里",5,5,0,7,5,2,4,1
10401,"高雄市","鼓山區忠正里",4,2,2,8,5,3,8,0
10401,"高雄市","鼓山區自強里",1,1,0,1,1,0,1,1
10401,"高雄市","湖內區大湖里",2,2,0,3,3,0,5,1
10401,"高雄市","湖內區公舘里",7,1,6,1,1,0,0,1
10401,"高雄市","湖內區海埔里",5,4,1,7,3,4,0,0
10401,"高雄市","湖內區海山里",0,0,0,5,3,2,1,0
10401,"高雄市","湖內區湖東里",8,4,4,2,1,1,4,0
10401,"高雄市","湖內區湖內里",6,2,4,4,2,2,8,3
10401,"高雄市","湖內區劉家里",0,0,0,1,0,1,0,0
10401,"高雄市","湖內區太爺里",1,1,0,2,2,0,1,0
10401,"高雄市","湖內區田尾里",1,1,0,1,0,1,3,0
10401,"高雄市","湖內區文賢里",3,2,1,3,1,2,3,2
10401,"高雄市","湖內區葉厝里",5,2,3,5,3,2,1,0
10401,"高雄市","湖內區逸賢里",0,0,0,1,0,1,1,1
10401,"高雄市","湖內區中賢里",0,0,0,4,3,1,1,1
10401,"高雄市","湖內區忠興里",1,1,0,3,3,0,0,0
10401,"高雄市","茄萣區白雲里",1,1,0,5,2,3,5,1
10401,"高雄市","茄萣區保定里",2,0,2,2,1,1,6,1
10401,"高雄市","茄萣區大定里",6,2,4,2,0,2,1,0
10401,"高雄市","茄萣區福德里",0,0,0,2,2,0,1,0
10401,"高雄市","茄萣區光定里",1,0,1,4,3,1,0,0
10401,"高雄市","茄萣區和協里",2,1,1,0,0,0,2,1
10401,"高雄市","茄萣區吉定里",2,1,1,2,2,0,1,0
10401,"高雄市","茄萣區嘉安里",3,2,1,2,1,1,3,0
10401,"高雄市","茄萣區嘉賜里",4,2,2,2,1,1,2,0
10401,"高雄市","茄萣區嘉定里",2,1,1,2,0,2,0,0
10401,"高雄市","茄萣區嘉福里",2,1,1,4,4,0,0,0
10401,"高雄市","茄萣區嘉樂里",2,1,1,3,2,1,3,1
10401,"高雄市","茄萣區嘉泰里",0,0,0,1,1,0,3,0
10401,"高雄市","茄萣區崎漏里",5,3,2,6,6,0,6,1
10401,"高雄市","茄萣區萬福里",1,1,0,6,4,2,0,0
10401,"高雄市","甲仙區寶隆里",0,0,0,4,2,2,0,0
10401,"高雄市","甲仙區大田里",1,1,0,4,2,2,1,0
10401,"高雄市","甲仙區東安里",1,0,1,2,1,1,0,0
10401,"高雄市","甲仙區關山里",2,1,1,1,1,0,0,1
10401,"高雄市","甲仙區和安里",0,0,0,2,2,0,0,1
10401,"高雄市","甲仙區西安里",0,0,0,1,0,1,3,0
10401,"高雄市","甲仙區小林里",0,0,0,2,1,1,0,0
10401,"高雄市","林園區北汕里",2,0,2,2,1,1,2,2
10401,"高雄市","林園區頂厝里",3,3,0,3,3,0,6,3
10401,"高雄市","林園區東林里",3,0,3,6,1,5,8,3
10401,"高雄市","林園區東汕里",0,0,0,2,0,2,2,0
10401,"高雄市","林園區鳳芸里",2,1,1,2,1,1,0,1
10401,"高雄市","林園區港埔里",0,0,0,3,2,1,1,1
10401,"高雄市","林園區港嘴里",6,3,3,2,1,1,4,1
10401,"高雄市","林園區龔厝里",4,2,2,3,2,1,2,0
10401,"高雄市","林園區廣應里",4,1,3,2,2,0,6,1
10401,"高雄市","林園區林家里",3,1,2,1,1,0,0,2
10401,"高雄市","林園區林內里",2,2,0,1,0,1,1,1
10401,"高雄市","林園區林園里",6,4,2,3,1,2,8,0
10401,"高雄市","林園區仁愛里",7,5,2,3,0,3,5,0
10401,"高雄市","林園區潭頭里",5,2,3,7,5,2,1,0
10401,"高雄市","林園區王公里",6,2,4,4,1,3,6,1
10401,"高雄市","林園區文賢里",0,0,0,4,2,2,2,1
10401,"高雄市","林園區五福里",5,3,2,3,3,0,1,2
10401,"高雄市","林園區溪州里",5,5,0,7,4,3,6,1
10401,"高雄市","林園區西汕里",3,0,3,4,3,1,1,0
10401,"高雄市","林園區西溪里",5,2,3,6,4,2,1,2
10401,"高雄市","林園區中厝里",7,5,2,8,6,2,4,0
10401,"高雄市","林園區中門里",5,1,4,2,2,0,6,1
10401,"高雄市","林園區中汕里",6,2,4,4,2,2,3,0
10401,"高雄市","林園區中芸里",3,1,2,2,2,0,1,0
10401,"高雄市","苓雅區安祥里",2,2,0,3,1,2,2,0
10401,"高雄市","苓雅區博仁里",1,1,0,1,1,0,0,0
10401,"高雄市","苓雅區朝陽里",2,2,0,4,2,2,3,0
10401,"高雄市","苓雅區城北里",1,0,1,0,0,0,2,0
10401,"高雄市","苓雅區城東里",2,1,1,5,1,4,3,0
10401,"高雄市","苓雅區城西里",1,0,1,1,1,0,1,0
10401,"高雄市","苓雅區福地里",5,2,3,0,0,0,3,1
10401,"高雄市","苓雅區福東里",2,0,2,4,2,2,4,0
10401,"高雄市","苓雅區福海里",0,0,0,4,2,2,0,0
10401,"高雄市","苓雅區福居里",3,1,2,4,3,1,5,0
10401,"高雄市","苓雅區福康里",2,1,1,1,1,0,1,1
10401,"高雄市","苓雅區福隆里",2,1,1,3,2,1,0,1
10401,"高雄市","苓雅區福南里",2,1,1,9,4,5,4,0
10401,"高雄市","苓雅區福人里",4,1,3,2,2,0,6,0
10401,"高雄市","苓雅區福壽里",1,0,1,2,1,1,0,0
10401,"高雄市","苓雅區福西里",1,1,0,5,3,2,2,0
10401,"高雄市","苓雅區福祥里",2,1,1,0,0,0,2,0
10401,"高雄市","苓雅區鼓中里",2,0,2,1,0,1,2,0
10401,"高雄市","苓雅區光華里",1,0,1,2,2,0,1,0
10401,"高雄市","苓雅區廣澤里",1,1,0,4,2,2,4,2
10401,"高雄市","苓雅區和煦里",4,1,3,1,1,0,3,0
10401,"高雄市","苓雅區華堂里",0,0,0,6,2,4,2,1
10401,"高雄市","苓雅區建軍里",2,2,0,2,2,0,0,0
10401,"高雄市","苓雅區凱旋里",4,2,2,6,3,3,2,1
10401,"高雄市","苓雅區林安里",3,2,1,1,1,0,1,0
10401,"高雄市","苓雅區林德里",1,0,1,3,2,1,2,0
10401,"高雄市","苓雅區林富里",2,1,1,1,0,1,2,0
10401,"高雄市","苓雅區林貴里",2,2,0,2,1,1,1,1
10401,"高雄市","苓雅區林華里",3,2,1,4,2,2,4,1
10401,"高雄市","苓雅區林靖里",2,2,0,3,3,0,2,0
10401,"高雄市","苓雅區林南里",2,2,0,2,1,1,2,1
10401,"高雄市","苓雅區林泉里",1,1,0,1,1,0,3,0
10401,"高雄市","苓雅區林榮里",6,2,4,5,4,1,4,2
10401,"高雄市","苓雅區林圍里",1,0,1,2,2,0,1,1
10401,"高雄市","苓雅區林西里",1,0,1,1,1,0,4,0
10401,"高雄市","苓雅區林興里",1,0,1,1,1,0,0,1
10401,"高雄市","苓雅區林中里",0,0,0,5,2,3,3,1
10401,"高雄市","苓雅區苓東里",2,0,2,4,0,4,1,0
10401,"高雄市","苓雅區苓昇里",1,0,1,3,2,1,0,1
10401,"高雄市","苓雅區苓雅里",1,0,1,0,0,0,5,1
10401,"高雄市","苓雅區苓中里",0,0,0,5,2,3,4,0
10401,"高雄市","苓雅區苓洲里",1,1,0,0,0,0,0,1
10401,"高雄市","苓雅區美田里",0,0,0,2,1,1,3,0
10401,"高雄市","苓雅區民主里",3,3,0,5,2,3,9,0
10401,"高雄市","苓雅區普天里",2,2,0,3,0,3,3,2
10401,"高雄市","苓雅區普照里",4,3,1,9,7,2,2,1
10401,"高雄市","苓雅區晴朗里",4,2,2,2,2,0,2,0
10401,"高雄市","苓雅區人和里",5,3,2,2,2,0,1,1
10401,"高雄市","苓雅區仁政里",1,1,0,1,0,1,0,2
10401,"高雄市","苓雅區日中里",1,1,0,0,0,0,2,0
10401,"高雄市","苓雅區尚義里",1,1,0,2,2,0,5,0
10401,"高雄市","苓雅區田西里",2,2,0,3,3,0,5,0
10401,"高雄市","苓雅區同慶里",0,0,0,5,0,5,3,0
10401,"高雄市","苓雅區衛武里",3,0,3,5,4,1,2,0
10401,"高雄市","苓雅區文昌里",11,4,7,3,1,2,7,2
10401,"高雄市","苓雅區五福里",5,3,2,5,3,2,2,0
10401,"高雄市","苓雅區五權里",1,0,1,2,2,0,2,0
10401,"高雄市","苓雅區意誠里",7,4,3,4,4,0,3,6
10401,"高雄市","苓雅區英明里",2,1,1,1,1,0,2,0
10401,"高雄市","苓雅區永康里",0,0,0,11,8,3,3,1
10401,"高雄市","苓雅區正大里",8,4,4,3,2,1,6,1
10401,"高雄市","苓雅區正道里",1,0,1,2,1,1,6,2
10401,"高雄市","苓雅區正仁里",4,0,4,4,1,3,5,0
10401,"高雄市","苓雅區正文里",4,4,0,4,3,1,1,1
10401,"高雄市","苓雅區正心里",3,1,2,2,1,1,7,1
10401,"高雄市","苓雅區正言里",2,2,0,2,2,0,4,1
10401,"高雄市","苓雅區正義里",3,2,1,5,3,2,3,0
10401,"高雄市","苓雅區中正里",1,1,0,1,1,0,6,2
10401,"高雄市","苓雅區奏捷里",1,1,0,1,1,0,3,1
10401,"高雄市","六龜區寶來里",0,0,0,0,0,0,0,1
10401,"高雄市","六龜區大津里",0,0,0,1,1,0,0,1
10401,"高雄市","六龜區荖濃里",1,0,1,4,2,2,0,1
10401,"高雄市","六龜區六龜里",0,0,0,1,0,1,0,0
10401,"高雄市","六龜區文武里",3,3,0,2,0,2,1,0
10401,"高雄市","六龜區新發里",0,0,0,3,3,0,0,0
10401,"高雄市","六龜區新寮里",0,0,0,4,3,1,0,0
10401,"高雄市","六龜區新威里",1,1,0,1,1,0,1,0
10401,"高雄市","六龜區新興里",1,1,0,0,0,0,1,0
10401,"高雄市","六龜區興龍里",0,0,0,3,1,2,1,1
10401,"高雄市","六龜區義寶里",3,2,1,1,0,1,1,1
10401,"高雄市","六龜區中興里",2,1,1,4,2,2,1,0
10401,"高雄市","路竹區北嶺里",0,0,0,2,2,0,2,0
10401,"高雄市","路竹區頂寮里",4,1,3,6,1,5,0,0
10401,"高雄市","路竹區後鄉里",1,0,1,1,0,1,0,0
10401,"高雄市","路竹區甲北里",1,1,0,1,0,1,1,0
10401,"高雄市","路竹區甲南里",1,1,0,6,2,4,5,2
10401,"高雄市","路竹區三爺里",1,1,0,1,0,1,2,1
10401,"高雄市","路竹區社東里",4,1,3,7,5,2,5,0
10401,"高雄市","路竹區社南里",12,10,2,3,2,1,4,2
10401,"高雄市","路竹區社西里",7,2,5,0,0,0,3,0
10401,"高雄市","路竹區社中里",0,0,0,3,2,1,1,0
10401,"高雄市","路竹區文北里",9,5,4,5,3,2,5,0
10401,"高雄市","路竹區文南里",1,0,1,3,2,1,4,1
10401,"高雄市","路竹區下坑里",2,1,1,7,3,4,1,3
10401,"高雄市","路竹區新達里",2,1,1,1,0,1,1,0
10401,"高雄市","路竹區鴨寮里",4,3,1,2,1,1,2,1
10401,"高雄市","路竹區竹東里",5,3,2,3,2,1,17,2
10401,"高雄市","路竹區竹滬里",1,1,0,5,3,2,0,0
10401,"高雄市","路竹區竹南里",5,5,0,4,3,1,3,1
10401,"高雄市","路竹區竹西里",5,4,1,4,0,4,6,0
10401,"高雄市","路竹區竹園里",3,3,0,2,1,1,5,2
10401,"高雄市","茂林區多納里",2,2,0,2,2,0,0,0
10401,"高雄市","茂林區茂林里",2,1,1,1,0,1,4,1
10401,"高雄市","茂林區萬山里",0,0,0,2,1,1,1,0
10401,"高雄市","美濃區德興里",3,1,2,5,4,1,3,2
10401,"高雄市","美濃區東門里",2,0,2,3,3,0,1,0
10401,"高雄市","美濃區福安里",4,2,2,13,8,5,5,1
10401,"高雄市","美濃區廣德里",0,0,0,8,3,5,3,0
10401,"高雄市","美濃區廣林里",3,2,1,5,3,2,1,0
10401,"高雄市","美濃區合和里",3,1,2,7,3,4,4,0
10401,"高雄市","美濃區吉東里",2,1,1,6,4,2,2,3
10401,"高雄市","美濃區吉和里",2,1,1,4,3,1,4,1
10401,"高雄市","美濃區吉洋里",4,1,3,5,3,2,0,0
10401,"高雄市","美濃區龍肚里",3,2,1,6,3,3,2,0
10401,"高雄市","美濃區龍山里",0,0,0,7,3,4,2,0
10401,"高雄市","美濃區祿興里",0,0,0,6,5,1,1,2
10401,"高雄市","美濃區瀰濃里",1,0,1,6,2,4,3,2
10401,"高雄市","美濃區清水里",1,0,1,4,2,2,0,1
10401,"高雄市","美濃區獅山里",1,0,1,8,6,2,1,1
10401,"高雄市","美濃區泰安里",1,0,1,4,2,2,1,3
10401,"高雄市","美濃區興隆里",1,1,0,1,1,0,2,0
10401,"高雄市","美濃區中壇里",3,1,2,5,3,2,1,1
10401,"高雄市","美濃區中圳里",0,0,0,7,4,3,3,1
10401,"高雄市","彌陀區光和里",0,0,0,1,1,0,2,0
10401,"高雄市","彌陀區過港里",0,0,0,3,3,0,2,0
10401,"高雄市","彌陀區海尾里",0,0,0,2,0,2,2,0
10401,"高雄市","彌陀區舊港里",4,3,1,2,0,2,3,0
10401,"高雄市","彌陀區漯底里",4,2,2,2,1,1,4,0
10401,"高雄市","彌陀區彌靖里",4,1,3,4,4,0,3,1
10401,"高雄市","彌陀區彌仁里",0,0,0,2,1,1,1,0
10401,"高雄市","彌陀區彌壽里",0,0,0,2,2,0,1,1
10401,"高雄市","彌陀區彌陀里",0,0,0,2,1,1,5,0
10401,"高雄市","彌陀區南寮里",2,0,2,5,5,0,1,1
10401,"高雄市","彌陀區文安里",1,0,1,8,5,3,3,0
10401,"高雄市","彌陀區鹽埕里",1,1,0,2,1,1,1,0
10401,"高雄市","那瑪夏區達卡努瓦里",3,1,2,6,5,1,5,0
10401,"高雄市","那瑪夏區瑪雅里",5,1,4,0,0,0,2,0
10401,"高雄市","那瑪夏區南沙魯里",0,0,0,3,2,1,0,0
10401,"高雄市","楠梓區翠屏里",19,8,11,13,10,3,21,7
10401,"高雄市","楠梓區大昌里",5,3,2,3,3,0,1,0
10401,"高雄市","楠梓區東寧里",7,2,5,7,3,4,8,2
10401,"高雄市","楠梓區福昌里",1,1,0,2,1,1,5,0
10401,"高雄市","楠梓區廣昌里",4,1,3,8,7,1,5,2
10401,"高雄市","楠梓區國昌里",5,4,1,5,3,2,1,0
10401,"高雄市","楠梓區和昌里",2,2,0,3,2,1,3,1
10401,"高雄市","楠梓區宏昌里",2,2,0,1,1,0,4,1
10401,"高雄市","楠梓區宏南里",2,1,1,4,2,2,0,0
10401,"高雄市","楠梓區宏榮里",2,1,1,7,5,2,2,1
10401,"高雄市","楠梓區宏毅里",2,0,2,4,4,0,2,1
10401,"高雄市","楠梓區惠豐里",10,4,6,9,5,4,6,3
10401,"高雄市","楠梓區惠民里",3,3,0,6,3,3,2,0
10401,"高雄市","楠梓區惠楠里",1,1,0,3,2,1,2,2
10401,"高雄市","楠梓區加昌里",16,6,10,9,3,6,16,4
10401,"高雄市","楠梓區建昌里",2,1,1,7,6,1,1,2
10401,"高雄市","楠梓區金田里",7,3,4,7,4,3,6,0
10401,"高雄市","楠梓區錦屏里",2,0,2,2,2,0,7,0
10401,"高雄市","楠梓區久昌里",1,1,0,3,0,3,1,4
10401,"高雄市","楠梓區藍田里",15,9,6,3,2,1,11,2
10401,"高雄市","楠梓區隆昌里",2,2,0,5,2,3,4,0
10401,"高雄市","楠梓區清豐里",41,25,16,11,7,4,44,6
10401,"高雄市","楠梓區慶昌里",3,0,3,4,2,2,2,1
10401,"高雄市","楠梓區仁昌里",11,7,4,7,5,2,10,5
10401,"高雄市","楠梓區稔田里",0,0,0,2,2,0,2,0
10401,"高雄市","楠梓區瑞屏里",4,4,0,1,0,1,3,1
10401,"高雄市","楠梓區盛昌里",5,3,2,1,1,0,5,2
10401,"高雄市","楠梓區泰昌里",2,1,1,4,1,3,2,1
10401,"高雄市","楠梓區五常里",9,4,5,10,6,4,11,4
10401,"高雄市","楠梓區享平里",4,4,0,4,2,2,4,1
10401,"高雄市","楠梓區興昌里",3,1,2,6,5,1,6,1
10401,"高雄市","楠梓區秀昌里",7,5,2,5,3,2,5,1
10401,"高雄市","楠梓區玉屏里",2,2,0,3,2,1,4,1
10401,"高雄市","楠梓區裕昌里",4,2,2,7,3,4,10,2
10401,"高雄市","楠梓區中和里",4,3,1,1,0,1,1,0
10401,"高雄市","楠梓區中興里",2,1,1,2,0,2,4,0
10401,"高雄市","楠梓區中陽里",6,3,3,2,0,2,5,1
10401,"高雄市","內門區東埔里",0,0,0,1,1,0,0,0
10401,"高雄市","內門區溝坪里",0,0,0,1,0,1,2,0
10401,"高雄市","內門區觀亭里",3,0,3,4,2,2,1,2
10401,"高雄市","內門區光興里",2,1,1,1,1,0,0,0
10401,"高雄市","內門區金竹里",1,1,0,1,0,1,0,0
10401,"高雄市","內門區木柵里",1,0,1,2,0,2,0,0
10401,"高雄市","內門區內東里",0,0,0,1,0,1,0,0
10401,"高雄市","內門區內豊里",2,0,2,2,1,1,1,0
10401,"高雄市","內門區內門里",0,0,0,0,0,0,1,0
10401,"高雄市","內門區內南里",0,0,0,0,0,0,0,0
10401,"高雄市","內門區內興里",1,1,0,3,2,1,2,0
10401,"高雄市","內門區瑞山里",0,0,0,1,1,0,0,0
10401,"高雄市","內門區三平里",0,0,0,1,1,0,0,0
10401,"高雄市","內門區石坑里",1,1,0,0,0,0,1,0
10401,"高雄市","內門區永富里",1,1,0,1,0,1,0,0
10401,"高雄市","內門區永吉里",0,0,0,2,2,0,0,0
10401,"高雄市","內門區永興里",0,0,0,0,0,0,0,0
10401,"高雄市","內門區中埔里",0,0,0,1,1,0,0,0
10401,"高雄市","鳥松區大華里",12,3,9,7,3,4,9,1
10401,"高雄市","鳥松區大竹里",0,0,0,0,0,0,2,0
10401,"高雄市","鳥松區坔埔里",1,1,0,6,2,4,4,0
10401,"高雄市","鳥松區華美里",5,3,2,8,5,3,4,0
10401,"高雄市","鳥松區夢裡里",11,4,7,3,2,1,7,1
10401,"高雄市","鳥松區鳥松里",15,10,5,17,13,4,9,4
10401,"高雄市","鳥松區仁美里",6,3,3,8,3,5,6,3
10401,"高雄市","旗津區安順里",5,1,4,1,1,0,0,0
10401,"高雄市","旗津區北汕里",7,4,3,3,3,0,2,2
10401,"高雄市","旗津區慈愛里",2,1,1,6,2,4,3,0
10401,"高雄市","旗津區復興里",5,1,4,5,2,3,7,2
10401,"高雄市","旗津區南汕里",7,4,3,3,2,1,3,0
10401,"高雄市","旗津區旗下里",6,5,1,4,3,1,1,0
10401,"高雄市","旗津區上竹里",13,6,7,5,4,1,6,0
10401,"高雄市","旗津區實踐里",1,0,1,3,0,3,1,0
10401,"高雄市","旗津區永安里",1,0,1,1,0,1,2,0
10401,"高雄市","旗津區振興里",1,0,1,6,4,2,1,1
10401,"高雄市","旗津區中華里",8,5,3,1,0,1,2,0
10401,"高雄市","旗津區中興里",4,2,2,6,3,3,4,0
10401,"高雄市","旗津區中洲里",2,1,1,2,2,0,2,2
10401,"高雄市","旗山區大德里",5,4,1,2,2,0,5,0
10401,"高雄市","旗山區大林里",1,1,0,4,2,2,0,0
10401,"高雄市","旗山區大山里",1,1,0,3,1,2,1,0
10401,"高雄市","旗山區東昌里",1,1,0,0,0,0,4,0
10401,"高雄市","旗山區東平里",3,2,1,4,2,2,2,0
10401,"高雄市","旗山區廣福里",0,0,0,2,2,0,0,0
10401,"高雄市","旗山區鯤洲里",1,0,1,3,2,1,0,1
10401,"高雄市","旗山區湄洲里",2,0,2,6,5,1,0,0
10401,"高雄市","旗山區南勝里",2,1,1,3,2,1,1,0
10401,"高雄市","旗山區南洲里",0,0,0,5,5,0,1,1
10401,"高雄市","旗山區瑞吉里",4,3,1,3,1,2,4,1
10401,"高雄市","旗山區三協里",1,1,0,2,2,0,3,1
10401,"高雄市","旗山區上洲里",2,0,2,5,3,2,0,0
10401,"高雄市","旗山區太平里",2,1,1,5,3,2,1,1
10401,"高雄市","旗山區新光里",1,0,1,1,1,0,0,1
10401,"高雄市","旗山區永和里",4,2,2,7,4,3,5,1
10401,"高雄市","旗山區圓富里",3,3,0,6,4,2,1,0
10401,"高雄市","旗山區中寮里",0,0,0,0,0,0,0,0
10401,"高雄市","旗山區中正里",3,2,1,4,1,3,1,0
10401,"高雄市","旗山區中洲里",0,0,0,4,3,1,1,0
10401,"高雄市","旗山區竹峰里",0,0,0,3,2,1,3,0
10401,"高雄市","前金區北金里",2,1,1,2,2,0,2,1
10401,"高雄市","前金區博孝里",3,2,1,1,0,1,0,0
10401,"高雄市","前金區草江里",1,0,1,1,1,0,3,0
10401,"高雄市","前金區東金里",0,0,0,2,1,1,0,0
10401,"高雄市","前金區復元里",0,0,0,3,3,0,0,1
10401,"高雄市","前金區國民里",0,0,0,1,1,0,3,0
10401,"高雄市","前金區後金里",0,0,0,0,0,0,1,1
10401,"高雄市","前金區林投里",0,0,0,5,3,2,0,2
10401,"高雄市","前金區民生里",0,0,0,0,0,0,1,0
10401,"高雄市","前金區青山里",2,0,2,3,2,1,4,0
10401,"高雄市","前金區榮復里",1,1,0,1,1,0,1,0
10401,"高雄市","前金區三川里",1,0,1,1,0,1,0,1
10401,"高雄市","前金區社東里",4,4,0,0,0,0,2,1
10401,"高雄市","前金區社西里",6,1,5,3,2,1,2,0
10401,"高雄市","前金區文東里",2,1,1,0,0,0,0,0
10401,"高雄市","前金區文西里",0,0,0,3,0,3,0,0
10401,"高雄市","前金區新生里",5,2,3,10,2,8,6,1
10401,"高雄市","前金區長城里",2,1,1,2,2,0,1,0
10401,"高雄市","前金區長生里",1,0,1,3,1,2,0,1
10401,"高雄市","前金區長興里",4,1,3,5,4,1,1,1
10401,"高雄市","前鎮區草衙里",17,6,11,15,10,5,7,5
10401,"高雄市","前鎮區德昌里",4,3,1,2,1,1,1,1
10401,"高雄市","前鎮區復國里",4,1,3,2,1,1,1,2
10401,"高雄市","前鎮區建隆里",2,1,1,5,4,1,1,1
10401,"高雄市","前鎮區良和里",4,1,3,3,0,3,3,1
10401,"高雄市","前鎮區民權里",6,3,3,3,2,1,6,2
10401,"高雄市","前鎮區明道里",1,1,0,2,1,1,2,0
10401,"高雄市","前鎮區明禮里",1,0,1,2,1,1,1,1
10401,"高雄市","前鎮區明孝里",3,2,1,4,1,3,4,2
10401,"高雄市","前鎮區明義里",6,2,4,3,1,2,2,2
10401,"高雄市","前鎮區明正里",11,6,5,7,4,3,9,1
10401,"高雄市","前鎮區平昌里",0,0,0,1,1,0,1,0
10401,"高雄市","前鎮區平等里",1,1,0,7,5,2,0,1
10401,"高雄市","前鎮區前鎮里",3,0,3,3,1,2,3,0
10401,"高雄市","前鎮區仁愛里",0,0,0,1,1,0,1,0
10401,"高雄市","前鎮區瑞北里",8,3,5,3,1,2,3,1
10401,"高雄市","前鎮區瑞昌里",6,2,4,3,2,1,3,1
10401,"高雄市","前鎮區瑞誠里",6,1,5,1,0,1,0,1
10401,"高雄市","前鎮區瑞東里",2,1,1,3,2,1,6,0
10401,"高雄市","前鎮區瑞豐里",3,1,2,6,5,1,2,1
10401,"高雄市","前鎮區瑞崗里",2,2,0,5,2,3,5,1
10401,"高雄市","前鎮區瑞和里",5,2,3,3,3,0,2,0
10401,"高雄市","前鎮區瑞華里",2,1,1,3,3,0,8,0
10401,"高雄市","前鎮區瑞隆里",6,1,5,6,4,2,2,1
10401,"高雄市","前鎮區瑞南里",10,3,7,9,8,1,5,4
10401,"高雄市","前鎮區瑞平里",7,3,4,2,0,2,5,0
10401,"高雄市","前鎮區瑞文里",1,0,1,3,2,1,2,3
10401,"高雄市","前鎮區瑞西里",6,4,2,5,1,4,6,4
10401,"高雄市","前鎮區瑞祥里",7,5,2,3,2,1,7,3
10401,"高雄市","前鎮區瑞興里",3,3,0,4,3,1,4,0
10401,"高雄市","前鎮區瑞竹里",5,3,2,2,2,0,3,0
10401,"高雄市","前鎮區盛豐里",2,1,1,4,2,2,4,3
10401,"高雄市","前鎮區盛興里",3,2,1,3,1,2,3,1
10401,"高雄市","前鎮區西甲里",1,0,1,0,0,0,0,0
10401,"高雄市","前鎮區西山里",6,2,4,10,5,5,7,0
10401,"高雄市","前鎮區信德里",6,5,1,3,1,2,2,3
10401,"高雄市","前鎮區信義里",2,0,2,0,0,0,2,1
10401,"高雄市","前鎮區興邦里",5,3,2,1,0,1,1,0
10401,"高雄市","前鎮區興東里",8,5,3,5,2,3,6,2
10401,"高雄市","前鎮區興化里",0,0,0,1,0,1,0,0
10401,"高雄市","前鎮區興仁里",1,0,1,4,3,1,1,0
10401,"高雄市","前鎮區興中里",6,2,4,3,2,1,3,2
10401,"高雄市","前鎮區振興里",7,2,5,2,1,1,4,1
10401,"高雄市","前鎮區鎮北里",1,1,0,1,1,0,1,0
10401,"高雄市","前鎮區鎮昌里",3,2,1,1,1,0,6,2
10401,"高雄市","前鎮區鎮東里",2,1,1,2,0,2,3,1
10401,"高雄市","前鎮區鎮海里",5,2,3,5,5,0,6,1
10401,"高雄市","前鎮區鎮榮里",2,0,2,4,1,3,3,0
10401,"高雄市","前鎮區鎮陽里",2,1,1,2,2,0,2,0
10401,"高雄市","前鎮區鎮中里",1,0,1,6,2,4,1,0
10401,"高雄市","前鎮區忠誠里",1,0,1,5,3,2,2,0
10401,"高雄市","前鎮區忠純里",6,2,4,16,11,5,5,3
10401,"高雄市","前鎮區忠孝里",5,2,3,7,5,2,7,0
10401,"高雄市","前鎮區竹北里",2,0,2,2,1,1,3,1
10401,"高雄市","前鎮區竹東里",6,3,3,1,1,0,3,1
10401,"高雄市","前鎮區竹南里",11,7,4,4,2,2,8,2
10401,"高雄市","前鎮區竹內里",2,2,0,4,3,1,2,0
10401,"高雄市","前鎮區竹西里",4,3,1,7,3,4,8,0
10401,"高雄市","前鎮區竹中里",4,1,3,2,1,1,3,0
10401,"高雄市","橋頭區白樹里",7,4,3,3,2,1,3,2
10401,"高雄市","橋頭區筆秀里",1,1,0,2,1,1,3,0
10401,"高雄市","橋頭區德松里",4,2,2,3,0,3,1,2
10401,"高雄市","橋頭區頂鹽里",1,1,0,4,2,2,0,0
10401,"高雄市","橋頭區東林里",2,1,1,2,1,1,4,2
10401,"高雄市","橋頭區甲北里",2,1,1,1,0,1,2,1
10401,"高雄市","橋頭區甲南里",3,3,0,5,5,0,4,2
10401,"高雄市","橋頭區橋南里",1,0,1,2,2,0,2,2
10401,"高雄市","橋頭區橋頭里",2,1,1,1,1,0,1,0
10401,"高雄市","橋頭區三德里",1,1,0,0,0,0,1,0
10401,"高雄市","橋頭區仕豐里",8,6,2,4,3,1,3,0
10401,"高雄市","橋頭區仕和里",7,5,2,2,1,1,0,2
10401,"高雄市","橋頭區仕隆里",2,0,2,5,4,1,1,2
10401,"高雄市","橋頭區西林里",0,0,0,1,1,0,2,1
10401,"高雄市","橋頭區新莊里",2,0,2,3,1,2,1,0
10401,"高雄市","橋頭區芋寮里",1,0,1,1,1,0,0,0
10401,"高雄市","橋頭區中崎里",3,2,1,0,0,0,0,0
10401,"高雄市","仁武區八卦里",36,21,15,8,5,3,18,5
10401,"高雄市","仁武區赤山里",12,8,4,6,3,3,7,1
10401,"高雄市","仁武區大灣里",9,4,5,2,2,0,7,1
10401,"高雄市","仁武區高楠里",4,2,2,5,2,3,1,0
10401,"高雄市","仁武區後安里",7,4,3,5,5,0,3,0
10401,"高雄市","仁武區考潭里",5,4,1,3,2,1,6,2
10401,"高雄市","仁武區仁慈里",2,1,1,0,0,0,4,1
10401,"高雄市","仁武區仁福里",0,0,0,2,2,0,1,0
10401,"高雄市","仁武區仁和里",18,12,6,1,0,1,4,2
10401,"高雄市","仁武區仁武里",8,4,4,5,5,0,10,3
10401,"高雄市","仁武區灣內里",19,7,12,10,3,7,9,2
10401,"高雄市","仁武區文武里",14,6,8,11,5,6,11,4
10401,"高雄市","仁武區烏林里",5,3,2,2,2,0,4,1
10401,"高雄市","仁武區五和里",11,8,3,3,2,1,7,0
10401,"高雄市","仁武區中華里",1,0,1,1,1,0,2,1
10401,"高雄市","仁武區竹後里",4,2,2,2,1,1,3,0
10401,"高雄市","三民區安邦里",7,5,2,4,3,1,8,1
10401,"高雄市","三民區安東里",2,1,1,5,3,2,5,0
10401,"高雄市","三民區安發里",6,3,3,2,2,0,5,1
10401,"高雄市","三民區安和里",4,1,3,2,2,0,2,1
10401,"高雄市","三民區安吉里",7,5,2,7,6,1,4,2
10401,"高雄市","三民區安康里",1,1,0,7,3,4,1,1
10401,"高雄市","三民區安寧里",4,2,2,4,2,2,2,3
10401,"高雄市","三民區安生里",0,0,0,0,0,0,2,0
10401,"高雄市","三民區安泰里",7,3,4,5,3,2,5,2
10401,"高雄市","三民區安宜里",3,1,2,9,7,2,3,1
10401,"高雄市","三民區寶安里",7,1,6,7,4,3,9,2
10401,"高雄市","三民區寶德里",10,4,6,7,4,3,7,3
10401,"高雄市","三民區寶國里",10,3,7,7,5,2,6,0
10401,"高雄市","三民區寶華里",6,2,4,4,3,1,5,2
10401,"高雄市","三民區寶龍里",5,2,3,3,1,2,3,0
10401,"高雄市","三民區寶民里",6,3,3,2,1,1,5,3
10401,"高雄市","三民區寶慶里",4,1,3,2,1,1,6,3
10401,"高雄市","三民區寶盛里",7,2,5,3,2,1,2,1
10401,"高雄市","三民區寶獅里",2,1,1,6,4,2,5,0
10401,"高雄市","三民區寶泰里",5,3,2,0,0,0,6,2
10401,"高雄市","三民區寶興里",8,3,5,6,4,2,6,5
10401,"高雄市","三民區寶業里",6,2,4,6,5,1,6,1
10401,"高雄市","三民區寶玉里",9,5,4,5,3,2,15,0
10401,"高雄市","三民區寶中里",6,3,3,3,2,1,7,1
10401,"高雄市","三民區寶珠里",4,2,2,9,8,1,8,3
10401,"高雄市","三民區本安里",7,5,2,3,0,3,3,1
10401,"高雄市","三民區本館里",13,8,5,6,3,3,13,6
10401,"高雄市","三民區本和里",17,7,10,5,1,4,12,4
10401,"高雄市","三民區本上里",3,1,2,5,2,3,8,0
10401,"高雄市","三民區本文里",3,1,2,2,1,1,1,1
10401,"高雄市","三民區本武里",5,4,1,0,0,0,4,0
10401,"高雄市","三民區本揚里",10,5,5,4,2,2,14,2
10401,"高雄市","三民區本元里",6,2,4,6,3,3,6,3
10401,"高雄市","三民區博愛里",4,3,1,5,2,3,0,0
10401,"高雄市","三民區博惠里",5,2,3,4,2,2,5,1
10401,"高雄市","三民區川東里",0,0,0,3,3,0,0,1
10401,"高雄市","三民區達德里",2,0,2,2,1,1,0,0
10401,"高雄市","三民區達明里",4,1,3,1,1,0,2,1
10401,"高雄市","三民區達仁里",3,0,3,2,1,1,2,0
10401,"高雄市","三民區達勇里",1,1,0,2,0,2,1,0
10401,"高雄市","三民區德北里",3,2,1,2,1,1,3,0
10401,"高雄市","三民區德東里",0,0,0,2,0,2,2,0
10401,"高雄市","三民區德仁里",2,2,0,1,1,0,1,1
10401,"高雄市","三民區德西里",0,0,0,0,0,0,3,0
10401,"高雄市","三民區德行里",1,0,1,2,1,1,0,0
10401,"高雄市","三民區德智里",1,0,1,4,2,2,3,0
10401,"高雄市","三民區鼎金里",7,4,3,4,1,3,12,2
10401,"高雄市","三民區鼎力里",5,2,3,1,1,0,5,0
10401,"高雄市","三民區鼎強里",13,10,3,2,2,0,3,0
10401,"高雄市","三民區鼎盛里",16,9,7,12,4,8,10,5
10401,"高雄市","三民區鼎泰里",27,16,11,16,7,9,32,6
10401,"高雄市","三民區鼎西里",7,3,4,8,4,4,11,5
10401,"高雄市","三民區鼎中里",8,6,2,5,5,0,5,0
10401,"高雄市","三民區豐裕里",2,1,1,3,1,2,3,2
10401,"高雄市","三民區鳳北里",2,1,1,2,0,2,0,1
10401,"高雄市","三民區鳳南里",0,0,0,3,0,3,0,0
10401,"高雄市","三民區港東里",1,0,1,4,0,4,1,0
10401,"高雄市","三民區港西里",2,0,2,1,1,0,0,0
10401,"高雄市","三民區港新里",1,1,0,1,0,1,1,1
10401,"高雄市","三民區建東里",1,1,0,2,2,0,1,0
10401,"高雄市","三民區精華里",1,1,0,2,2,0,1,2
10401,"高雄市","三民區力行里",1,0,1,3,1,2,3,0
10401,"高雄市","三民區立誠里",2,1,1,4,3,1,1,0
10401,"高雄市","三民區立德里",1,1,0,1,1,0,2,1
10401,"高雄市","三民區立業里",1,0,1,4,2,2,2,0
10401,"高雄市","三民區民享里",4,2,2,5,3,2,3,1
10401,"高雄市","三民區千北里",2,2,0,5,3,2,3,0
10401,"高雄市","三民區千秋里",2,1,1,3,2,1,2,1
10401,"高雄市","三民區千歲里",3,0,3,0,0,0,2,0
10401,"高雄市","三民區十美里",1,0,1,1,1,0,4,0
10401,"高雄市","三民區十全里",1,1,0,3,2,1,4,1
10401,"高雄市","三民區同德里",3,2,1,2,1,1,4,1
10401,"高雄市","三民區灣愛里",6,3,3,8,6,2,3,2
10401,"高雄市","三民區灣成里",6,1,5,3,1,2,6,0
10401,"高雄市","三民區灣復里",6,3,3,6,3,3,7,3
10401,"高雄市","三民區灣華里",2,1,1,7,6,1,8,3
10401,"高雄市","三民區灣利里",2,1,1,2,1,1,1,0
10401,"高雄市","三民區灣勝里",3,1,2,3,3,0,1,1
10401,"高雄市","三民區灣興里",4,2,2,7,5,2,4,1
10401,"高雄市","三民區灣中里",5,4,1,5,4,1,8,6
10401,"高雄市","三民區灣子里",7,4,3,5,5,0,3,3
10401,"高雄市","三民區興德里",3,0,3,5,3,2,0,2
10401,"高雄市","三民區裕民里",7,2,5,3,0,3,2,0
10401,"高雄市","三民區長明里",1,1,0,3,2,1,2,0
10401,"高雄市","三民區正順里",8,2,6,5,3,2,5,1
10401,"高雄市","三民區正興里",20,12,8,8,3,5,12,5
10401,"高雄市","杉林區大愛里",2,1,1,5,4,1,3,0
10401,"高雄市","杉林區集來里",2,1,1,5,4,1,0,0
10401,"高雄市","杉林區木梓里",0,0,0,1,0,1,0,1
10401,"高雄市","杉林區杉林里",1,1,0,2,2,0,1,0
10401,"高雄市","杉林區上平里",1,0,1,4,2,2,3,2
10401,"高雄市","杉林區新庄里",0,0,0,3,1,2,0,0
10401,"高雄市","杉林區月眉里",2,1,1,3,3,0,1,0
10401,"高雄市","杉林區月美里",1,1,0,6,4,2,0,0
10401,"高雄市","桃源區寶山里",2,1,1,0,0,0,1,0
10401,"高雄市","桃源區復興里",1,0,1,1,0,1,0,0
10401,"高雄市","桃源區高中里",2,1,1,1,0,1,2,0
10401,"高雄市","桃源區建山里",1,1,0,2,1,1,0,1
10401,"高雄市","桃源區拉芙蘭里",0,0,0,0,0,0,0,0
10401,"高雄市","桃源區梅山里",1,0,1,0,0,0,0,0
10401,"高雄市","桃源區勤和里",0,0,0,0,0,0,0,0
10401,"高雄市","桃源區桃源里",1,1,0,2,2,0,0,0
10401,"高雄市","田寮區崇德里",1,0,1,4,3,1,1,0
10401,"高雄市","田寮區大同里",0,0,0,0,0,0,0,0
10401,"高雄市","田寮區古亭里",0,0,0,6,3,3,0,0
10401,"高雄市","田寮區鹿埔里",1,0,1,0,0,0,0,0
10401,"高雄市","田寮區南安里",0,0,0,4,2,2,0,0
10401,"高雄市","田寮區七星里",0,0,0,2,0,2,0,1
10401,"高雄市","田寮區三和里",0,0,0,0,0,0,0,0
10401,"高雄市","田寮區田寮里",0,0,0,2,2,0,1,1
10401,"高雄市","田寮區西德里",0,0,0,3,1,2,0,0
10401,"高雄市","田寮區新興里",1,0,1,4,2,2,1,0
10401,"高雄市","小港區大苓里",5,3,2,4,2,2,5,2
10401,"高雄市","小港區大坪里",9,4,5,3,2,1,6,1
10401,"高雄市","小港區店鎮里",7,5,2,4,3,1,12,2
10401,"高雄市","小港區二苓里",1,0,1,5,2,3,6,2
10401,"高雄市","小港區鳳宮里",0,0,0,2,2,0,1,1
10401,"高雄市","小港區鳳林里",11,7,4,4,3,1,4,0
10401,"高雄市","小港區鳳鳴里",3,2,1,6,4,2,5,1
10401,"高雄市","小港區鳳森里",3,3,0,4,3,1,0,0
10401,"高雄市","小港區鳳興里",5,2,3,4,3,1,6,1
10401,"高雄市","小港區鳳源里",3,1,2,5,1,4,4,1
10401,"高雄市","小港區港后里",3,2,1,2,1,1,4,2
10401,"高雄市","小港區港口里",2,1,1,3,0,3,3,0
10401,"高雄市","小港區港明里",8,7,1,9,7,2,8,3
10401,"高雄市","小港區港南里",3,0,3,5,2,3,2,1
10401,"高雄市","小港區港墘里",2,2,0,1,0,1,1,1
10401,"高雄市","小港區港興里",3,1,2,0,0,0,3,1
10401,"高雄市","小港區港正里",4,2,2,4,2,2,3,0
10401,"高雄市","小港區高松里",5,3,2,5,4,1,6,0
10401,"高雄市","小港區桂林里",12,8,4,8,3,5,6,3
10401,"高雄市","小港區合作里",3,1,2,6,3,3,1,1
10401,"高雄市","小港區宏亮里",2,1,1,4,3,1,5,3
10401,"高雄市","小港區濟南里",7,1,6,4,3,1,3,0
10401,"高雄市","小港區孔宅里",4,3,1,4,1,3,5,2
10401,"高雄市","小港區六苓里",5,3,2,3,2,1,5,1
10401,"高雄市","小港區龍鳳里",5,2,3,4,3,1,4,0
10401,"高雄市","小港區坪頂里",16,7,9,7,4,3,11,0
10401,"高雄市","小港區青島里",0,0,0,4,3,1,1,0
10401,"高雄市","小港區三苓里",2,0,2,1,0,1,1,1
10401,"高雄市","小港區廈莊里",2,0,2,2,2,0,5,3
10401,"高雄市","小港區山東里",4,3,1,9,5,4,5,3
10401,"高雄市","小港區山明里",15,6,9,10,7,3,14,9
10401,"高雄市","小港區順苓里",6,3,3,5,2,3,6,1
10401,"高雄市","小港區松金里",6,3,3,6,3,3,1,5
10401,"高雄市","小港區松山里",11,5,6,4,2,2,7,2
10401,"高雄市","小港區泰山里",4,3,1,3,3,0,4,1
10401,"高雄市","小港區小港里",4,2,2,2,1,1,1,0
10401,"高雄市","小港區正苓里",6,3,3,4,1,3,4,1
10401,"高雄市","小港區中厝里",2,1,1,4,4,0,1,0
10401,"高雄市","新興區愛平里",0,0,0,3,1,2,3,1
10401,"高雄市","新興區成功里",0,0,0,2,1,1,2,1
10401,"高雄市","新興區大明里",2,1,1,2,1,1,0,0
10401,"高雄市","新興區德生里",5,3,2,2,1,1,5,0
10401,"高雄市","新興區德望里",5,3,2,2,1,1,4,0
10401,"高雄市","新興區德政里",1,0,1,0,0,0,0,1
10401,"高雄市","新興區東坡里",1,1,0,1,1,0,2,0
10401,"高雄市","新興區光耀里",3,1,2,2,0,2,3,2
10401,"高雄市","新興區漢民里",1,0,1,1,0,1,1,0
10401,"高雄市","新興區浩然里",2,2,0,5,2,3,3,0
10401,"高雄市","新興區華聲里",1,1,0,2,2,0,1,0
10401,"高雄市","新興區建華里",0,0,0,1,1,0,1,0
10401,"高雄市","新興區建興里",1,1,0,1,1,0,2,0
10401,"高雄市","新興區蕉園里",1,1,0,0,0,0,0,1
10401,"高雄市","新興區開平里",5,3,2,3,2,1,3,1
10401,"高雄市","新興區黎明里",3,1,2,4,3,1,0,0
10401,"高雄市","新興區明莊里",0,0,0,0,0,0,0,0
10401,"高雄市","新興區南港里",4,1,3,6,3,3,5,1
10401,"高雄市","新興區秋山里",2,1,1,6,4,2,2,0
10401,"高雄市","新興區仁聲里",2,1,1,0,0,0,0,0
10401,"高雄市","新興區榮治里",1,1,0,3,1,2,2,0
10401,"高雄市","新興區順昌里",3,2,1,1,1,0,3,0
10401,"高雄市","新興區文昌里",3,1,2,3,2,1,4,0
10401,"高雄市","新興區新江里",1,1,0,1,1,0,3,0
10401,"高雄市","新興區興昌里",1,0,1,2,1,1,2,0
10401,"高雄市","新興區永寧里",2,1,1,3,1,2,2,0
10401,"高雄市","新興區玉衡里",1,1,0,1,0,1,0,0
10401,"高雄市","新興區長驛里",0,0,0,3,2,1,1,2
10401,"高雄市","新興區振成里",1,0,1,1,0,1,0,0
10401,"高雄市","新興區振華里",1,0,1,6,5,1,3,0
10401,"高雄市","新興區正氣里",3,1,2,0,0,0,0,0
10401,"高雄市","新興區中東里",2,1,1,7,4,3,3,1
10401,"高雄市","鹽埕區博愛里",0,0,0,2,1,1,0,0
10401,"高雄市","鹽埕區慈愛里",0,0,0,1,1,0,0,0
10401,"高雄市","鹽埕區府北里",1,1,0,4,4,0,3,0
10401,"高雄市","鹽埕區港都里",0,0,0,3,2,1,0,0
10401,"高雄市","鹽埕區光明里",0,0,0,3,2,1,1,0
10401,"高雄市","鹽埕區河濱里",0,0,0,3,2,1,1,0
10401,"高雄市","鹽埕區江南里",1,0,1,1,0,1,0,0
10401,"高雄市","鹽埕區江西里",2,1,1,1,1,0,2,0
10401,"高雄市","鹽埕區教仁里",3,2,1,6,5,1,3,3
10401,"高雄市","鹽埕區瀨南里",0,0,0,2,1,1,0,1
10401,"高雄市","鹽埕區藍橋里",0,0,0,3,2,1,1,1
10401,"高雄市","鹽埕區陸橋里",2,2,0,1,0,1,0,0
10401,"高雄市","鹽埕區南端里",1,0,1,0,0,0,0,0
10401,"高雄市","鹽埕區沙地里",0,0,0,0,0,0,0,0
10401,"高雄市","鹽埕區壽星里",1,0,1,3,1,2,3,0
10401,"高雄市","鹽埕區新豐里",2,1,1,3,1,2,2,1
10401,"高雄市","鹽埕區新化里",0,0,0,0,0,0,1,1
10401,"高雄市","鹽埕區新樂里",0,0,0,1,0,1,3,0
10401,"高雄市","鹽埕區育仁里",0,0,0,2,1,1,1,0
10401,"高雄市","鹽埕區中山里",2,1,1,3,3,0,4,0
10401,"高雄市","鹽埕區中原里",0,0,0,2,0,2,1,1
10401,"高雄市","燕巢區安招里",6,3,3,13,10,3,1,0
10401,"高雄市","燕巢區東燕里",2,1,1,0,0,0,4,1
10401,"高雄市","燕巢區鳳雄里",3,1,2,6,4,2,5,0
10401,"高雄市","燕巢區橫山里",3,2,1,2,1,1,2,1
10401,"高雄市","燕巢區尖山里",0,0,0,3,3,0,1,1
10401,"高雄市","燕巢區角宿里",7,4,3,5,1,4,3,1
10401,"高雄市","燕巢區金山里",1,0,1,0,0,0,0,0
10401,"高雄市","燕巢區南燕里",5,3,2,7,6,1,7,0
10401,"高雄市","燕巢區瓊林里",2,1,1,1,1,0,2,1
10401,"高雄市","燕巢區深水里",2,1,1,1,0,1,1,0
10401,"高雄市","燕巢區西燕里",6,3,3,2,2,0,7,1
10401,"高雄市","永安區保寧里",6,2,4,5,3,2,7,3
10401,"高雄市","永安區維新里",5,1,4,7,5,2,3,2
10401,"高雄市","永安區新港里",3,1,2,2,0,2,0,0
10401,"高雄市","永安區鹽田里",0,0,0,2,1,1,0,0
10401,"高雄市","永安區永安里",3,1,2,5,3,2,3,0
10401,"高雄市","永安區永華里",9,4,5,3,1,2,2,0
10401,"高雄市","梓官區赤東里",4,1,3,4,2,2,2,0
10401,"高雄市","梓官區赤崁里",3,1,2,2,2,0,4,0
10401,"高雄市","梓官區赤西里",2,2,0,1,1,0,0,0
10401,"高雄市","梓官區大舍里",7,3,4,6,1,5,7,0
10401,"高雄市","梓官區典寶里",4,2,2,3,3,0,3,2
10401,"高雄市","梓官區茄苳里",2,2,0,10,6,4,6,0
10401,"高雄市","梓官區禮蚵里",5,3,2,3,2,1,4,0
10401,"高雄市","梓官區同安里",0,0,0,2,0,2,2,1
10401,"高雄市","梓官區信蚵里",4,3,1,4,2,2,4,2
10401,"高雄市","梓官區智蚵里",5,4,1,3,2,1,3,0
10401,"高雄市","梓官區中崙里",2,0,2,1,0,1,2,0
10401,"高雄市","梓官區梓和里",3,1,2,4,3,1,0,0
10401,"高雄市","梓官區梓平里",3,2,1,3,0,3,4,1
10401,"高雄市","梓官區梓信里",3,1,2,3,2,1,1,1
10401,"高雄市","梓官區梓義里",3,1,2,3,2,1,5,0
10401,"高雄市","左營區菜公里",49,27,22,24,19,5,37,13
10401,"高雄市","左營區城南里",1,1,0,1,0,1,0,0
10401,"高雄市","左營區崇實里",19,11,8,6,3,3,7,2
10401,"高雄市","左營區頂北里",0,0,0,1,0,1,0,0
10401,"高雄市","左營區頂西里",1,1,0,2,2,0,2,0
10401,"高雄市","左營區福山里",63,32,31,21,12,9,40,19
10401,"高雄市","左營區光輝里",1,0,1,7,4,3,1,0
10401,"高雄市","左營區果峰里",1,0,1,5,4,1,3,2
10401,"高雄市","左營區果惠里",1,0,1,3,1,2,1,1
10401,"高雄市","左營區果貿里",5,2,3,9,8,1,5,1
10401,"高雄市","左營區海勝里",8,4,4,16,10,6,8,5
10401,"高雄市","左營區合群里",2,1,1,11,6,5,1,1
10401,"高雄市","左營區進學里",2,2,0,7,7,0,2,0
10401,"高雄市","左營區莒光里",0,0,0,2,2,0,0,0
10401,"高雄市","左營區路東里",0,0,0,1,0,1,2,1
10401,"高雄市","左營區廟北里",0,0,0,2,1,1,2,0
10401,"高雄市","左營區廟東里",0,0,0,1,1,0,1,0
10401,"高雄市","左營區明建里",2,1,1,2,2,0,1,0
10401,"高雄市","左營區埤北里",1,1,0,6,4,2,3,0
10401,"高雄市","左營區埤東里",0,0,0,1,0,1,0,1
10401,"高雄市","左營區埤西里",1,0,1,2,1,1,1,1
10401,"高雄市","左營區屏山里",5,3,2,4,3,1,3,2
10401,"高雄市","左營區廍北里",0,0,0,1,0,1,1,0
10401,"高雄市","左營區廍南里",0,0,0,2,1,1,3,0
10401,"高雄市","左營區聖后里",1,0,1,3,2,1,2,0
10401,"高雄市","左營區聖南里",1,1,0,0,0,0,2,0
10401,"高雄市","左營區聖西里",0,0,0,0,0,0,0,0
10401,"高雄市","左營區尾北里",5,4,1,5,3,2,2,1
10401,"高雄市","左營區尾南里",0,0,0,3,2,1,0,0
10401,"高雄市","左營區尾西里",2,1,1,1,0,1,1,1
10401,"高雄市","左營區祥和里",0,0,0,3,2,1,2,0
10401,"高雄市","左營區新光里",24,14,10,11,6,5,18,7
10401,"高雄市","左營區新上里",31,17,14,24,13,11,22,10
10401,"高雄市","左營區新下里",15,6,9,11,9,2,19,4
10401,"高雄市","左營區新中里",6,3,3,8,6,2,6,3
10401,"高雄市","左營區永清里",3,2,1,2,2,0,1,1
10401,"高雄市","左營區中北里",1,1,0,1,1,0,1,0
10401,"高雄市","左營區中南里",1,1,0,1,1,0,2,0
10401,"高雄市","左營區自助里",0,0,0,1,0,1,1,1
10403,"高雄市","阿蓮區阿蓮里",6,3,3,10,4,6,6,1
10403,"高雄市","阿蓮區峯山里",1,1,0,1,1,0,1,1
10403,"高雄市","阿蓮區復安里",2,2,0,4,1,3,2,0
10403,"高雄市","阿蓮區崗山里",0,0,0,1,1,0,0,0
10403,"高雄市","阿蓮區港後里",2,0,2,0,0,0,4,0
10403,"高雄市","阿蓮區和蓮里",5,1,4,5,1,4,2,0
10403,"高雄市","阿蓮區南蓮里",4,4,0,1,0,1,2,2
10403,"高雄市","阿蓮區青旗里",1,1,0,3,2,1,0,0
10403,"高雄市","阿蓮區清蓮里",6,3,3,7,5,2,1,1
10403,"高雄市","阿蓮區石安里",2,0,2,3,3,0,1,2
10403,"高雄市","阿蓮區玉庫里",0,0,0,0,0,0,0,1
10403,"高雄市","阿蓮區中路里",2,1,1,3,1,2,4,2
10403,"高雄市","大寮區潮寮里",8,5,3,7,4,3,2,0
10403,"高雄市","大寮區大寮里",8,4,4,8,5,3,9,3
10403,"高雄市","大寮區光武里",0,0,0,0,0,0,1,0
10403,"高雄市","大寮區過溪里",7,4,3,3,3,0,5,1
10403,"高雄市","大寮區後庄里",10,7,3,11,7,4,7,4
10403,"高雄市","大寮區會結里",4,3,1,6,5,1,2,0
10403,"高雄市","大寮區會社里",4,1,3,13,10,3,6,3
10403,"高雄市","大寮區江山里",4,4,0,2,1,1,2,3
10403,"高雄市","大寮區拷潭里",1,0,1,2,1,1,0,2
10403,"高雄市","大寮區琉球里",8,2,6,6,5,1,8,0
10403,"高雄市","大寮區內坑里",15,7,8,9,7,2,7,2
10403,"高雄市","大寮區前庄里",2,1,1,4,1,3,2,1
10403,"高雄市","大寮區三隆里",3,2,1,17,12,5,6,1
10403,"高雄市","大寮區山頂里",7,6,1,16,8,8,7,3
10403,"高雄市","大寮區上寮里",5,2,3,4,3,1,5,2
10403,"高雄市","大寮區翁園里",6,3,3,5,4,1,5,2
10403,"高雄市","大寮區溪寮里",2,1,1,4,1,3,1,1
10403,"高雄市","大寮區新厝里",3,1,2,1,0,1,1,0
10403,"高雄市","大寮區義和里",3,2,1,2,1,1,5,1
10403,"高雄市","大寮區義仁里",1,1,0,2,2,0,2,2
10403,"高雄市","大寮區永芳里",8,2,6,12,10,2,9,1
10403,"高雄市","大寮區昭明里",3,3,0,5,4,1,2,3
10403,"高雄市","大寮區中興里",5,1,4,10,4,6,8,4
10403,"高雄市","大寮區中庄里",20,8,12,15,12,3,19,5
10403,"高雄市","大寮區忠義里",0,0,0,4,3,1,0,3
10403,"高雄市","大社區保安里",6,4,2,2,2,0,6,1
10403,"高雄市","大社區保社里",2,2,0,3,1,2,4,2
10403,"高雄市","大社區翠屏里",3,1,2,3,2,1,2,0
10403,"高雄市","大社區大社里",11,5,6,8,5,3,6,3
10403,"高雄市","大社區觀音里",8,6,2,4,0,4,2,4
10403,"高雄市","大社區嘉誠里",0,0,0,2,1,1,2,0
10403,"高雄市","大社區三奶里",5,2,3,6,3,3,3,0
10403,"高雄市","大社區神農里",7,4,3,6,5,1,8,2
10403,"高雄市","大社區中里里",4,2,2,3,1,2,2,0
10403,"高雄市","大樹區大坑里",2,0,2,3,2,1,0,0
10403,"高雄市","大樹區大樹里",3,3,0,6,3,3,0,1
10403,"高雄市","大樹區姑山里",2,0,2,2,2,0,0,1
10403,"高雄市","大樹區和山里",1,1,0,1,0,1,0,0
10403,"高雄市","大樹區井腳里",0,0,0,4,1,3,1,1
10403,"高雄市","大樹區九曲里",15,7,8,6,4,2,5,1
10403,"高雄市","大樹區久堂里",7,5,2,5,3,2,4,2
10403,"高雄市","大樹區龍目里",3,0,3,6,5,1,1,0
10403,"高雄市","大樹區三和里",1,0,1,1,0,1,2,0
10403,"高雄市","大樹區檨腳里",2,1,1,5,2,3,1,3
10403,"高雄市","大樹區水安里",7,5,2,6,3,3,2,0
10403,"高雄市","大樹區水寮里",4,3,1,5,3,2,4,2
10403,"高雄市","大樹區統嶺里",1,0,1,1,1,0,0,0
10403,"高雄市","大樹區溪埔里",1,1,0,1,0,1,1,0
10403,"高雄市","大樹區小坪里",1,1,0,1,1,0,1,1
10403,"高雄市","大樹區興山里",0,0,0,3,3,0,1,0
10403,"高雄市","大樹區興田里",1,0,1,0,0,0,1,2
10403,"高雄市","大樹區竹寮里",4,2,2,2,2,0,1,1
10403,"高雄市","鳳山區保安里",15,10,5,2,2,0,9,2
10403,"高雄市","鳳山區北門里",3,1,2,6,1,5,2,2
10403,"高雄市","鳳山區曹公里",7,5,2,2,1,1,6,0
10403,"高雄市","鳳山區成功里",1,0,1,0,0,0,0,0
10403,"高雄市","鳳山區誠德里",0,0,0,3,1,2,1,0
10403,"高雄市","鳳山區誠信里",1,0,1,1,1,0,3,0
10403,"高雄市","鳳山區誠義里",10,7,3,1,1,0,4,2
10403,"高雄市","鳳山區誠智里",3,2,1,6,4,2,1,1
10403,"高雄市","鳳山區大德里",11,4,7,7,5,2,3,1
10403,"高雄市","鳳山區東門里",8,5,3,8,7,1,8,4
10403,"高雄市","鳳山區二甲里",7,6,1,5,2,3,6,4
10403,"高雄市","鳳山區鳳東里",9,4,5,9,4,5,12,5
10403,"高雄市","鳳山區鳳崗里",0,0,0,6,5,1,4,0
10403,"高雄市","鳳山區福誠里",6,1,5,2,1,1,3,1
10403,"高雄市","鳳山區福祥里",5,4,1,1,1,0,5,0
10403,"高雄市","鳳山區福興里",8,3,5,8,5,3,7,4
10403,"高雄市","鳳山區富甲里",4,2,2,5,5,0,5,0
10403,"高雄市","鳳山區富榮里",8,7,1,3,1,2,2,1
10403,"高雄市","鳳山區光明里",2,2,0,3,2,1,1,1
10403,"高雄市","鳳山區國富里",4,1,3,1,0,1,1,1
10403,"高雄市","鳳山區國光里",4,3,1,2,1,1,6,3
10403,"高雄市","鳳山區國隆里",3,1,2,3,0,3,6,2
10403,"高雄市","鳳山區國泰里",7,1,6,7,3,4,5,2
10403,"高雄市","鳳山區過埤里",26,10,16,12,3,9,21,8
10403,"高雄市","鳳山區海光里",4,2,2,9,6,3,4,2
10403,"高雄市","鳳山區海洋里",5,3,2,2,1,1,2,1
10403,"高雄市","鳳山區和德里",2,2,0,1,0,1,1,1
10403,"高雄市","鳳山區和興里",5,3,2,6,3,3,5,3
10403,"高雄市","鳳山區老爺里",10,3,7,6,3,3,8,3
10403,"高雄市","鳳山區龍成里",3,2,1,0,0,0,6,1
10403,"高雄市","鳳山區南成里",14,8,6,7,3,4,8,5
10403,"高雄市","鳳山區南和里",4,4,0,3,1,2,4,2
10403,"高雄市","鳳山區南興里",3,1,2,1,0,1,1,0
10403,"高雄市","鳳山區埤頂里",8,4,4,12,9,3,6,3
10403,"高雄市","鳳山區瑞興里",5,0,5,12,7,5,5,3
10403,"高雄市","鳳山區瑞竹里",19,6,13,7,7,0,8,4
10403,"高雄市","鳳山區三民里",2,0,2,2,1,1,2,0
10403,"高雄市","鳳山區善美里",9,3,6,5,4,1,5,1
10403,"高雄市","鳳山區生明里",5,2,3,4,2,2,0,2
10403,"高雄市","鳳山區天興里",7,4,3,2,0,2,12,1
10403,"高雄市","鳳山區文德里",10,5,5,5,2,3,14,4
10403,"高雄市","鳳山區文福里",24,14,10,3,1,2,13,3
10403,"高雄市","鳳山區文衡里",9,6,3,2,1,1,7,2
10403,"高雄市","鳳山區文華里",15,4,11,10,4,6,9,3
10403,"高雄市","鳳山區文山里",6,3,3,11,6,5,11,2
10403,"高雄市","鳳山區文英里",7,1,6,4,1,3,8,1
10403,"高雄市","鳳山區五福里",7,3,4,3,2,1,1,1
10403,"高雄市","鳳山區武漢里",7,4,3,10,6,4,3,0
10403,"高雄市","鳳山區武慶里",5,1,4,3,0,3,3,0
10403,"高雄市","鳳山區武松里",2,0,2,3,1,2,3,1
10403,"高雄市","鳳山區縣口里",1,1,0,0,0,0,0,0
10403,"高雄市","鳳山區縣衙里",0,0,0,1,1,0,0,1
10403,"高雄市","鳳山區協和里",4,2,2,4,2,2,6,1
10403,"高雄市","鳳山區新富里",9,6,3,7,5,2,4,0
10403,"高雄市","鳳山區新甲里",7,4,3,4,4,0,4,1
10403,"高雄市","鳳山區新樂里",9,7,2,5,4,1,4,3
10403,"高雄市","鳳山區新強里",10,8,2,5,4,1,14,3
10403,"高雄市","鳳山區新泰里",7,3,4,4,2,2,3,2
10403,"高雄市","鳳山區新武里",5,4,1,1,1,0,3,1
10403,"高雄市","鳳山區新興里",2,1,1,4,4,0,1,1
10403,"高雄市","鳳山區興仁里",7,3,4,2,1,1,6,0
10403,"高雄市","鳳山區興中里",3,2,1,0,0,0,5,0
10403,"高雄市","鳳山區一甲里",7,4,3,7,4,3,2,1
10403,"高雄市","鳳山區鎮北里",35,20,15,7,6,1,14,3
10403,"高雄市","鳳山區鎮東里",5,3,2,4,3,1,3,0
10403,"高雄市","鳳山區鎮南里",6,4,2,7,5,2,6,2
10403,"高雄市","鳳山區鎮西里",7,3,4,8,6,2,3,1
10403,"高雄市","鳳山區正義里",10,6,4,3,1,2,4,0
10403,"高雄市","鳳山區中和里",2,2,0,7,5,2,3,4
10403,"高雄市","鳳山區中崙里",5,3,2,2,2,0,2,0
10403,"高雄市","鳳山區中民里",7,6,1,4,3,1,8,2
10403,"高雄市","鳳山區中榮里",3,2,1,8,5,3,4,2
10403,"高雄市","鳳山區中正里",4,2,2,8,6,2,2,1
10403,"高雄市","鳳山區忠誠里",5,2,3,4,1,3,9,1
10403,"高雄市","鳳山區忠孝里",10,5,5,9,4,5,5,5
10403,"高雄市","鳳山區忠義里",3,1,2,4,3,1,5,1
10403,"高雄市","岡山區白米里",4,3,1,7,7,0,3,0
10403,"高雄市","岡山區本洲里",4,2,2,1,1,0,0,1
10403,"高雄市","岡山區碧紅里",4,0,4,4,1,3,8,1
10403,"高雄市","岡山區程香里",5,1,4,5,5,0,4,4
10403,"高雄市","岡山區大遼里",3,1,2,2,1,1,4,1
10403,"高雄市","岡山區大莊里",2,1,1,2,1,1,0,1
10403,"高雄市","岡山區福興里",0,0,0,1,0,1,0,1
10403,"高雄市","岡山區岡山里",3,2,1,3,3,0,2,7
10403,"高雄市","岡山區和平里",1,0,1,0,0,0,1,0
10403,"高雄市","岡山區後紅里",7,2,5,4,3,1,7,1
10403,"高雄市","岡山區後協里",5,4,1,9,8,1,6,2
10403,"高雄市","岡山區華崗里",4,2,2,4,3,1,3,2
10403,"高雄市","岡山區嘉峰里",4,2,2,6,2,4,2,1
10403,"高雄市","岡山區嘉興里",4,0,4,6,3,3,3,4
10403,"高雄市","岡山區劉厝里",3,3,0,4,1,3,0,0
10403,"高雄市","岡山區平安里",2,2,0,1,0,1,3,0
10403,"高雄市","岡山區前峰里",5,4,1,2,0,2,4,1
10403,"高雄市","岡山區仁壽里",4,3,1,6,4,2,3,0
10403,"高雄市","岡山區仁義里",3,2,1,8,5,3,2,1
10403,"高雄市","岡山區三和里",3,2,1,1,1,0,1,0
10403,"高雄市","岡山區石潭里",1,0,1,2,2,0,2,0
10403,"高雄市","岡山區壽峰里",3,0,3,3,2,1,6,2
10403,"高雄市","岡山區壽天里",6,4,2,4,2,2,1,2
10403,"高雄市","岡山區台上里",7,4,3,6,2,4,4,4
10403,"高雄市","岡山區潭底里",2,2,0,1,1,0,0,0
10403,"高雄市","岡山區灣裡里",9,6,3,4,4,0,4,0
10403,"高雄市","岡山區維仁里",1,0,1,3,1,2,0,1
10403,"高雄市","岡山區為隨里",1,0,1,3,2,1,2,0
10403,"高雄市","岡山區協和里",3,2,1,5,3,2,4,3
10403,"高雄市","岡山區協榮里",5,3,2,3,3,0,2,1
10403,"高雄市","岡山區信義里",4,1,3,1,0,1,0,1
10403,"高雄市","岡山區忠孝里",4,3,1,17,10,7,5,0
10403,"高雄市","岡山區竹圍里",10,6,4,4,3,1,12,3
10403,"高雄市","鼓山區寶樹里",0,0,0,5,3,2,4,0
10403,"高雄市","鼓山區登山里",0,0,0,4,4,0,0,0
10403,"高雄市","鼓山區峰南里",0,0,0,1,0,1,1,0
10403,"高雄市","鼓山區鼓峰里",3,1,2,7,5,2,3,1
10403,"高雄市","鼓山區鼓岩里",4,2,2,4,1,3,1,0
10403,"高雄市","鼓山區光化里",1,1,0,3,2,1,2,0
10403,"高雄市","鼓山區光榮里",2,1,1,4,3,1,4,1
10403,"高雄市","鼓山區河邊里",2,2,0,4,1,3,4,1
10403,"高雄市","鼓山區厚生里",6,1,5,1,1,0,7,0
10403,"高雄市","鼓山區華豐里",6,5,1,3,3,0,2,2
10403,"高雄市","鼓山區惠安里",1,0,1,5,2,3,0,3
10403,"高雄市","鼓山區建國里",4,3,1,2,2,0,2,2
10403,"高雄市","鼓山區麗興里",2,2,0,1,1,0,1,0
10403,"高雄市","鼓山區龍井里",1,0,1,5,5,0,1,2
10403,"高雄市","鼓山區龍水里",55,32,23,21,13,8,24,10
10403,"高雄市","鼓山區龍子里",43,23,20,13,6,7,23,5
10403,"高雄市","鼓山區綠川里",3,2,1,2,0,2,1,0
10403,"高雄市","鼓山區民強里",2,1,1,3,2,1,5,1
10403,"高雄市","鼓山區民族里",0,0,0,0,0,0,1,0
10403,"高雄市","鼓山區明誠里",35,21,14,19,13,6,17,8
10403,"高雄市","鼓山區內惟里",0,0,0,1,0,1,1,0
10403,"高雄市","鼓山區平和里",3,2,1,7,3,4,5,0
10403,"高雄市","鼓山區前峰里",5,4,1,7,2,5,6,2
10403,"高雄市","鼓山區山下里",0,0,0,1,1,0,1,1
10403,"高雄市","鼓山區哨船頭里",2,0,2,2,0,2,1,1
10403,"高雄市","鼓山區壽山里",1,1,0,3,1,2,4,1
10403,"高雄市","鼓山區樹德里",3,1,2,0,0,0,0,0
10403,"高雄市","鼓山區桃源里",4,1,3,0,0,0,1,0
10403,"高雄市","鼓山區維生里",0,0,0,2,1,1,2,0
10403,"高雄市","鼓山區新民里",2,1,1,0,0,0,2,0
10403,"高雄市","鼓山區興宗里",0,0,0,3,2,1,1,2
10403,"高雄市","鼓山區雄峰里",0,0,0,5,2,3,5,1
10403,"高雄市","鼓山區延平里",1,1,0,0,0,0,0,0
10403,"高雄市","鼓山區裕豐里",3,2,1,4,3,1,5,5
10403,"高雄市","鼓山區裕興里",5,2,3,2,0,2,7,4
10403,"高雄市","鼓山區正德里",6,4,2,2,2,0,1,1
10403,"高雄市","鼓山區忠正里",6,1,5,6,4,2,2,3
10403,"高雄市","鼓山區自強里",1,0,1,2,2,0,0,0
10403,"高雄市","湖內區大湖里",11,5,6,3,2,1,5,2
10403,"高雄市","湖內區公舘里",6,4,2,5,4,1,2,0
10403,"高雄市","湖內區海埔里",4,1,3,2,1,1,1,0
10403,"高雄市","湖內區海山里",3,3,0,5,3,2,1,0
10403,"高雄市","湖內區湖東里",5,2,3,5,3,2,7,0
10403,"高雄市","湖內區湖內里",3,1,2,5,2,3,6,1
10403,"高雄市","湖內區劉家里",0,0,0,6,5,1,1,0
10403,"高雄市","湖內區太爺里",1,0,1,1,1,0,2,0
10403,"高雄市","湖內區田尾里",2,1,1,2,1,1,2,0
10403,"高雄市","湖內區文賢里",2,1,1,0,0,0,1,0
10403,"高雄市","湖內區葉厝里",3,3,0,6,2,4,8,1
10403,"高雄市","湖內區逸賢里",2,1,1,2,1,1,1,0
10403,"高雄市","湖內區中賢里",3,1,2,5,4,1,2,1
10403,"高雄市","湖內區忠興里",1,0,1,2,2,0,0,0
10403,"高雄市","茄萣區白雲里",1,1,0,4,3,1,2,1
10403,"高雄市","茄萣區保定里",2,0,2,5,3,2,1,0
10403,"高雄市","茄萣區大定里",2,2,0,2,2,0,0,0
10403,"高雄市","茄萣區福德里",3,1,2,4,4,0,1,0
10403,"高雄市","茄萣區光定里",1,0,1,1,1,0,0,1
10403,"高雄市","茄萣區和協里",2,1,1,5,5,0,0,0
10403,"高雄市","茄萣區吉定里",1,0,1,3,1,2,0,0
10403,"高雄市","茄萣區嘉安里",1,1,0,2,1,1,4,0
10403,"高雄市","茄萣區嘉賜里",5,2,3,3,1,2,8,1
10403,"高雄市","茄萣區嘉定里",1,0,1,1,0,1,0,0
10403,"高雄市","茄萣區嘉福里",2,1,1,2,0,2,1,0
10403,"高雄市","茄萣區嘉樂里",4,3,1,2,1,1,1,0
10403,"高雄市","茄萣區嘉泰里",1,0,1,2,0,2,0,0
10403,"高雄市","茄萣區崎漏里",9,3,6,7,4,3,1,1
10403,"高雄市","茄萣區萬福里",1,1,0,2,1,1,1,2
10403,"高雄市","甲仙區寶隆里",0,0,0,4,4,0,0,1
10403,"高雄市","甲仙區大田里",3,3,0,6,4,2,0,1
10403,"高雄市","甲仙區東安里",0,0,0,2,0,2,0,0
10403,"高雄市","甲仙區關山里",1,1,0,1,1,0,1,0
10403,"高雄市","甲仙區和安里",0,0,0,3,2,1,0,0
10403,"高雄市","甲仙區西安里",0,0,0,0,0,0,0,0
10403,"高雄市","甲仙區小林里",0,0,0,1,1,0,1,1
10403,"高雄市","林園區北汕里",2,2,0,2,2,0,2,0
10403,"高雄市","林園區頂厝里",10,7,3,8,7,1,6,6
10403,"高雄市","林園區東林里",3,1,2,7,3,4,8,1
10403,"高雄市","林園區東汕里",1,0,1,2,2,0,0,0
10403,"高雄市","林園區鳳芸里",3,1,2,3,3,0,2,0
10403,"高雄市","林園區港埔里",4,2,2,2,1,1,1,1
10403,"高雄市","林園區港嘴里",4,3,1,2,2,0,2,1
10403,"高雄市","林園區龔厝里",2,0,2,2,1,1,1,1
10403,"高雄市","林園區廣應里",10,6,4,7,4,3,3,1
10403,"高雄市","林園區林家里",2,0,2,2,1,1,1,0
10403,"高雄市","林園區林內里",3,1,2,5,3,2,2,1
10403,"高雄市","林園區林園里",9,7,2,3,1,2,2,2
10403,"高雄市","林園區仁愛里",1,1,0,5,4,1,2,1
10403,"高雄市","林園區潭頭里",3,1,2,8,3,5,5,1
10403,"高雄市","林園區王公里",5,3,2,6,5,1,3,0
10403,"高雄市","林園區文賢里",1,1,0,4,3,1,3,0
10403,"高雄市","林園區五福里",7,5,2,6,4,2,7,0
10403,"高雄市","林園區溪州里",9,6,3,8,5,3,7,2
10403,"高雄市","林園區西汕里",1,0,1,3,3,0,0,0
10403,"高雄市","林園區西溪里",4,2,2,6,5,1,0,1
10403,"高雄市","林園區中厝里",5,2,3,8,5,3,1,2
10403,"高雄市","林園區中門里",6,2,4,5,4,1,0,2
10403,"高雄市","林園區中汕里",3,3,0,6,2,4,3,2
10403,"高雄市","林園區中芸里",1,0,1,5,2,3,1,0
10403,"高雄市","苓雅區安祥里",2,2,0,6,5,1,2,2
10403,"高雄市","苓雅區博仁里",0,0,0,2,0,2,0,1
10403,"高雄市","苓雅區朝陽里",4,3,1,4,3,1,3,0
10403,"高雄市","苓雅區城北里",2,1,1,1,1,0,2,1
10403,"高雄市","苓雅區城東里",1,0,1,3,2,1,3,0
10403,"高雄市","苓雅區城西里",0,0,0,1,1,0,0,0
10403,"高雄市","苓雅區福地里",3,3,0,5,1,4,4,0
10403,"高雄市","苓雅區福東里",10,5,5,4,2,2,0,2
10403,"高雄市","苓雅區福海里",2,1,1,1,0,1,2,1
10403,"高雄市","苓雅區福居里",2,0,2,7,3,4,5,0
10403,"高雄市","苓雅區福康里",2,1,1,6,5,1,2,1
10403,"高雄市","苓雅區福隆里",2,2,0,4,3,1,1,1
10403,"高雄市","苓雅區福南里",1,1,0,3,1,2,1,1
10403,"高雄市","苓雅區福人里",4,3,1,3,0,3,5,0
10403,"高雄市","苓雅區福壽里",1,1,0,6,3,3,0,1
10403,"高雄市","苓雅區福西里",1,1,0,3,3,0,1,1
10403,"高雄市","苓雅區福祥里",3,0,3,4,3,1,3,2
10403,"高雄市","苓雅區鼓中里",0,0,0,4,2,2,1,1
10403,"高雄市","苓雅區光華里",0,0,0,1,0,1,0,0
10403,"高雄市","苓雅區廣澤里",1,1,0,2,1,1,4,1
10403,"高雄市","苓雅區和煦里",5,3,2,6,2,4,1,0
10403,"高雄市","苓雅區華堂里",4,1,3,2,2,0,4,2
10403,"高雄市","苓雅區建軍里",2,1,1,4,3,1,1,1
10403,"高雄市","苓雅區凱旋里",2,1,1,3,1,2,1,2
10403,"高雄市","苓雅區林安里",4,3,1,3,2,1,2,1
10403,"高雄市","苓雅區林德里",4,1,3,1,0,1,2,0
10403,"高雄市","苓雅區林富里",1,1,0,2,1,1,3,2
10403,"高雄市","苓雅區林貴里",2,1,1,4,2,2,1,0
10403,"高雄市","苓雅區林華里",0,0,0,1,0,1,5,3
10403,"高雄市","苓雅區林靖里",3,1,2,1,0,1,1,0
10403,"高雄市","苓雅區林南里",2,1,1,0,0,0,1,1
10403,"高雄市","苓雅區林泉里",2,2,0,0,0,0,3,0
10403,"高雄市","苓雅區林榮里",2,0,2,0,0,0,4,4
10403,"高雄市","苓雅區林圍里",1,1,0,1,1,0,4,0
10403,"高雄市","苓雅區林西里",2,2,0,3,1,2,3,2
10403,"高雄市","苓雅區林興里",0,0,0,2,2,0,2,0
10403,"高雄市","苓雅區林中里",3,3,0,3,1,2,5,2
10403,"高雄市","苓雅區苓東里",3,2,1,2,1,1,0,0
10403,"高雄市","苓雅區苓昇里",0,0,0,4,2,2,5,1
10403,"高雄市","苓雅區苓雅里",1,0,1,0,0,0,1,2
10403,"高雄市","苓雅區苓中里",0,0,0,2,2,0,0,0
10403,"高雄市","苓雅區苓洲里",3,2,1,1,1,0,2,2
10403,"高雄市","苓雅區美田里",0,0,0,1,1,0,1,0
10403,"高雄市","苓雅區民主里",4,1,3,9,7,2,4,1
10403,"高雄市","苓雅區普天里",6,3,3,6,2,4,6,2
10403,"高雄市","苓雅區普照里",4,1,3,2,2,0,5,0
10403,"高雄市","苓雅區晴朗里",0,0,0,1,1,0,1,1
10403,"高雄市","苓雅區人和里",2,0,2,3,1,2,2,2
10403,"高雄市","苓雅區仁政里",0,0,0,0,0,0,0,0
10403,"高雄市","苓雅區日中里",3,2,1,4,3,1,2,1
10403,"高雄市","苓雅區尚義里",2,0,2,1,1,0,3,0
10403,"高雄市","苓雅區田西里",1,0,1,1,1,0,1,0
10403,"高雄市","苓雅區同慶里",1,0,1,5,3,2,2,1
10403,"高雄市","苓雅區衛武里",0,0,0,6,4,2,0,0
10403,"高雄市","苓雅區文昌里",5,2,3,8,5,3,5,3
10403,"高雄市","苓雅區五福里",3,1,2,4,1,3,8,3
10403,"高雄市","苓雅區五權里",0,0,0,4,4,0,6,1
10403,"高雄市","苓雅區意誠里",1,0,1,1,0,1,4,3
10403,"高雄市","苓雅區英明里",3,2,1,6,3,3,3,1
10403,"高雄市","苓雅區永康里",0,0,0,4,2,2,2,0
10403,"高雄市","苓雅區正大里",7,2,5,4,0,4,10,2
10403,"高雄市","苓雅區正道里",6,2,4,6,2,4,6,2
10403,"高雄市","苓雅區正仁里",6,4,2,4,4,0,4,1
10403,"高雄市","苓雅區正文里",2,2,0,2,0,2,3,1
10403,"高雄市","苓雅區正心里",4,2,2,5,3,2,3,0
10403,"高雄市","苓雅區正言里",5,1,4,2,0,2,6,1
10403,"高雄市","苓雅區正義里",5,0,5,6,2,4,2,0
10403,"高雄市","苓雅區中正里",3,1,2,5,2,3,2,0
10403,"高雄市","苓雅區奏捷里",1,0,1,2,1,1,1,2
10403,"高雄市","六龜區寶來里",1,0,1,2,2,0,1,1
10403,"高雄市","六龜區大津里",1,0,1,1,1,0,1,1
10403,"高雄市","六龜區荖濃里",3,3,0,7,2,5,1,2
10403,"高雄市","六龜區六龜里",0,0,0,5,4,1,1,1
10403,"高雄市","六龜區文武里",1,0,1,3,2,1,1,1
10403,"高雄市","六龜區新發里",1,1,0,3,2,1,0,1
10403,"高雄市","六龜區新寮里",1,0,1,2,0,2,0,0
10403,"高雄市","六龜區新威里",1,0,1,2,2,0,0,1
10403,"高雄市","六龜區新興里",2,1,1,4,2,2,0,0
10403,"高雄市","六龜區興龍里",0,0,0,4,2,2,0,0
10403,"高雄市","六龜區義寶里",1,0,1,2,1,1,0,0
10403,"高雄市","六龜區中興里",2,0,2,5,1,4,2,1
10403,"高雄市","路竹區北嶺里",1,0,1,4,2,2,1,1
10403,"高雄市","路竹區頂寮里",0,0,0,1,0,1,2,1
10403,"高雄市","路竹區後鄉里",1,1,0,2,1,1,0,0
10403,"高雄市","路竹區甲北里",2,1,1,7,5,2,3,0
10403,"高雄市","路竹區甲南里",4,2,2,5,2,3,4,0
10403,"高雄市","路竹區三爺里",1,1,0,1,1,0,1,0
10403,"高雄市","路竹區社東里",1,0,1,3,2,1,1,0
10403,"高雄市","路竹區社南里",6,3,3,8,3,5,2,1
10403,"高雄市","路竹區社西里",3,1,2,3,2,1,4,0
10403,"高雄市","路竹區社中里",3,2,1,3,0,3,2,0
10403,"高雄市","路竹區文北里",5,2,3,2,2,0,7,2
10403,"高雄市","路竹區文南里",3,1,2,2,1,1,1,1
10403,"高雄市","路竹區下坑里",5,2,3,6,4,2,4,2
10403,"高雄市","路竹區新達里",4,1,3,1,0,1,2,0
10403,"高雄市","路竹區鴨寮里",5,2,3,3,2,1,0,0
10403,"高雄市","路竹區竹東里",7,4,3,8,5,3,7,2
10403,"高雄市","路竹區竹滬里",5,3,2,3,2,1,6,1
10403,"高雄市","路竹區竹南里",2,0,2,6,2,4,4,2
10403,"高雄市","路竹區竹西里",1,0,1,6,3,3,2,1
10403,"高雄市","路竹區竹園里",4,3,1,1,1,0,1,0
10403,"高雄市","茂林區多納里",1,1,0,1,0,1,2,0
10403,"高雄市","茂林區茂林里",0,0,0,1,1,0,4,0
10403,"高雄市","茂林區萬山里",0,0,0,1,1,0,0,0
10403,"高雄市","美濃區德興里",3,2,1,3,2,1,2,1
10403,"高雄市","美濃區東門里",0,0,0,1,1,0,2,0
10403,"高雄市","美濃區福安里",3,1,2,5,4,1,7,1
10403,"高雄市","美濃區廣德里",4,3,1,4,1,3,0,0
10403,"高雄市","美濃區廣林里",1,1,0,6,3,3,2,1
10403,"高雄市","美濃區合和里",0,0,0,3,0,3,3,1
10403,"高雄市","美濃區吉東里",2,2,0,8,3,5,2,1
10403,"高雄市","美濃區吉和里",1,1,0,5,3,2,3,1
10403,"高雄市","美濃區吉洋里",2,1,1,6,2,4,0,0
10403,"高雄市","美濃區龍肚里",1,1,0,5,3,2,1,1
10403,"高雄市","美濃區龍山里",0,0,0,4,4,0,0,1
10403,"高雄市","美濃區祿興里",4,3,1,6,5,1,4,0
10403,"高雄市","美濃區瀰濃里",2,1,1,6,1,5,3,2
10403,"高雄市","美濃區清水里",2,2,0,3,2,1,1,0
10403,"高雄市","美濃區獅山里",6,3,3,9,6,3,2,2
10403,"高雄市","美濃區泰安里",2,1,1,7,6,1,1,0
10403,"高雄市","美濃區興隆里",1,0,1,0,0,0,1,0
10403,"高雄市","美濃區中壇里",3,0,3,5,3,2,1,1
10403,"高雄市","美濃區中圳里",3,2,1,3,1,2,2,1
10403,"高雄市","彌陀區光和里",4,1,3,1,1,0,1,0
10403,"高雄市","彌陀區過港里",2,1,1,2,1,1,0,1
10403,"高雄市","彌陀區海尾里",0,0,0,1,1,0,0,0
10403,"高雄市","彌陀區舊港里",3,2,1,2,2,0,0,2
10403,"高雄市","彌陀區漯底里",0,0,0,3,3,0,2,1
10403,"高雄市","彌陀區彌靖里",2,2,0,4,1,3,1,1
10403,"高雄市","彌陀區彌仁里",0,0,0,2,1,1,0,1
10403,"高雄市","彌陀區彌壽里",0,0,0,1,1,0,1,0
10403,"高雄市","彌陀區彌陀里",5,0,5,2,0,2,6,1
10403,"高雄市","彌陀區南寮里",5,4,1,1,0,1,1,2
10403,"高雄市","彌陀區文安里",3,2,1,2,2,0,3,1
10403,"高雄市","彌陀區鹽埕里",7,5,2,6,2,4,4,1
10403,"高雄市","那瑪夏區達卡努瓦里",2,0,2,3,2,1,2,2
10403,"高雄市","那瑪夏區瑪雅里",3,1,2,1,1,0,1,0
10403,"高雄市","那瑪夏區南沙魯里",0,0,0,1,1,0,1,1
10403,"高雄市","楠梓區翠屏里",21,11,10,17,7,10,18,11
10403,"高雄市","楠梓區大昌里",1,1,0,6,4,2,3,1
10403,"高雄市","楠梓區東寧里",9,7,2,1,0,1,9,1
10403,"高雄市","楠梓區福昌里",3,2,1,5,4,1,4,2
10403,"高雄市","楠梓區廣昌里",5,3,2,6,4,2,2,1
10403,"高雄市","楠梓區國昌里",10,5,5,1,0,1,2,0
10403,"高雄市","楠梓區和昌里",0,0,0,4,2,2,2,0
10403,"高雄市","楠梓區宏昌里",7,2,5,7,5,2,3,3
10403,"高雄市","楠梓區宏南里",2,0,2,3,1,2,2,0
10403,"高雄市","楠梓區宏榮里",4,2,2,15,14,1,1,0
10403,"高雄市","楠梓區宏毅里",0,0,0,11,9,2,3,1
10403,"高雄市","楠梓區惠豐里",7,6,1,5,4,1,4,1
10403,"高雄市","楠梓區惠民里",10,6,4,4,2,2,8,1
10403,"高雄市","楠梓區惠楠里",7,5,2,8,5,3,4,1
10403,"高雄市","楠梓區加昌里",10,5,5,9,6,3,16,9
10403,"高雄市","楠梓區建昌里",6,2,4,7,5,2,5,3
10403,"高雄市","楠梓區金田里",3,3,0,7,3,4,5,0
10403,"高雄市","楠梓區錦屏里",4,3,1,3,1,2,3,1
10403,"高雄市","楠梓區久昌里",5,2,3,4,4,0,3,1
10403,"高雄市","楠梓區藍田里",15,4,11,4,2,2,12,3
10403,"高雄市","楠梓區隆昌里",9,5,4,4,1,3,2,4
10403,"高雄市","楠梓區清豐里",48,20,28,13,8,5,25,10
10403,"高雄市","楠梓區慶昌里",2,1,1,9,4,5,4,0
10403,"高雄市","楠梓區仁昌里",9,2,7,7,2,5,9,4
10403,"高雄市","楠梓區稔田里",1,1,0,1,1,0,4,1
10403,"高雄市","楠梓區瑞屏里",9,3,6,6,3,3,5,1
10403,"高雄市","楠梓區盛昌里",11,10,1,3,1,2,6,2
10403,"高雄市","楠梓區泰昌里",4,2,2,1,0,1,0,0
10403,"高雄市","楠梓區五常里",7,3,4,7,3,4,12,4
10403,"高雄市","楠梓區享平里",7,3,4,0,0,0,6,1
10403,"高雄市","楠梓區興昌里",8,3,5,3,2,1,7,1
10403,"高雄市","楠梓區秀昌里",2,0,2,5,5,0,2,1
10403,"高雄市","楠梓區玉屏里",5,4,1,5,4,1,4,1
10403,"高雄市","楠梓區裕昌里",11,5,6,4,4,0,8,2
10403,"高雄市","楠梓區中和里",4,2,2,4,1,3,5,2
10403,"高雄市","楠梓區中興里",1,0,1,2,2,0,2,1
10403,"高雄市","楠梓區中陽里",4,1,3,7,4,3,4,2
10403,"高雄市","內門區東埔里",1,0,1,1,1,0,0,1
10403,"高雄市","內門區溝坪里",1,1,0,4,3,1,0,0
10403,"高雄市","內門區觀亭里",1,1,0,5,2,3,0,0
10403,"高雄市","內門區光興里",1,1,0,3,2,1,0,0
10403,"高雄市","內門區金竹里",0,0,0,1,0,1,1,0
10403,"高雄市","內門區木柵里",2,2,0,1,0,1,0,0
10403,"高雄市","內門區內東里",1,0,1,1,1,0,2,0
10403,"高雄市","內門區內豊里",1,0,1,3,3,0,1,0
10403,"高雄市","內門區內門里",3,2,1,6,3,3,1,0
10403,"高雄市","內門區內南里",1,1,0,2,0,2,1,0
10403,"高雄市","內門區內興里",1,0,1,2,0,2,0,0
10403,"高雄市","內門區瑞山里",2,1,1,2,1,1,1,0
10403,"高雄市","內門區三平里",0,0,0,2,2,0,0,0
10403,"高雄市","內門區石坑里",0,0,0,3,2,1,0,0
10403,"高雄市","內門區永富里",1,0,1,2,2,0,0,0
10403,"高雄市","內門區永吉里",1,1,0,0,0,0,0,0
10403,"高雄市","內門區永興里",0,0,0,1,1,0,0,0
10403,"高雄市","內門區中埔里",0,0,0,1,1,0,0,0
10403,"高雄市","鳥松區大華里",13,8,5,6,3,3,14,5
10403,"高雄市","鳥松區大竹里",1,1,0,0,0,0,0,0
10403,"高雄市","鳥松區坔埔里",3,3,0,5,2,3,3,1
10403,"高雄市","鳥松區華美里",7,2,5,7,4,3,3,3
10403,"高雄市","鳥松區夢裡里",9,3,6,8,5,3,8,2
10403,"高雄市","鳥松區鳥松里",16,9,7,18,12,6,20,3
10403,"高雄市","鳥松區仁美里",14,7,7,7,3,4,4,2
10403,"高雄市","旗津區安順里",1,1,0,1,1,0,0,0
10403,"高雄市","旗津區北汕里",7,4,3,2,1,1,2,3
10403,"高雄市","旗津區慈愛里",10,6,4,4,1,3,2,1
10403,"高雄市","旗津區復興里",9,6,3,2,1,1,5,2
10403,"高雄市","旗津區南汕里",2,0,2,2,2,0,1,2
10403,"高雄市","旗津區旗下里",1,0,1,5,3,2,1,0
10403,"高雄市","旗津區上竹里",12,7,5,2,1,1,6,1
10403,"高雄市","旗津區實踐里",2,1,1,2,1,1,2,1
10403,"高雄市","旗津區永安里",2,1,1,0,0,0,3,1
10403,"高雄市","旗津區振興里",2,0,2,4,1,3,4,0
10403,"高雄市","旗津區中華里",1,0,1,3,1,2,1,2
10403,"高雄市","旗津區中興里",4,4,0,3,1,2,3,1
10403,"高雄市","旗津區中洲里",2,1,1,3,2,1,1,1
10403,"高雄市","旗山區大德里",3,1,2,6,3,3,6,1
10403,"高雄市","旗山區大林里",2,0,2,6,4,2,2,0
10403,"高雄市","旗山區大山里",1,1,0,6,1,5,3,0
10403,"高雄市","旗山區東昌里",0,0,0,0,0,0,0,0
10403,"高雄市","旗山區東平里",4,2,2,5,4,1,1,1
10403,"高雄市","旗山區廣福里",1,1,0,2,0,2,0,0
10403,"高雄市","旗山區鯤洲里",0,0,0,1,1,0,1,0
10403,"高雄市","旗山區湄洲里",1,0,1,3,3,0,2,0
10403,"高雄市","旗山區南勝里",2,2,0,7,6,1,3,0
10403,"高雄市","旗山區南洲里",1,1,0,5,2,3,2,0
10403,"高雄市","旗山區瑞吉里",4,2,2,2,2,0,3,0
10403,"高雄市","旗山區三協里",3,2,1,2,2,0,0,1
10403,"高雄市","旗山區上洲里",2,0,2,1,1,0,1,0
10403,"高雄市","旗山區太平里",5,1,4,3,1,2,2,3
10403,"高雄市","旗山區新光里",1,0,1,3,3,0,0,0
10403,"高雄市","旗山區永和里",6,3,3,9,5,4,1,3
10403,"高雄市","旗山區圓富里",0,0,0,1,1,0,0,1
10403,"高雄市","旗山區中寮里",0,0,0,3,2,1,0,0
10403,"高雄市","旗山區中正里",1,1,0,9,5,4,0,1
10403,"高雄市","旗山區中洲里",1,0,1,0,0,0,1,0
10403,"高雄市","旗山區竹峰里",4,2,2,5,5,0,1,2
10403,"高雄市","前金區北金里",1,0,1,3,3,0,0,0
10403,"高雄市","前金區博孝里",0,0,0,3,2,1,1,0
10403,"高雄市","前金區草江里",2,2,0,1,0,1,1,1
10403,"高雄市","前金區東金里",2,1,1,2,2,0,1,0
10403,"高雄市","前金區復元里",1,0,1,1,0,1,2,0
10403,"高雄市","前金區國民里",0,0,0,1,1,0,0,0
10403,"高雄市","前金區後金里",0,0,0,1,1,0,1,1
10403,"高雄市","前金區林投里",2,2,0,3,3,0,0,0
10403,"高雄市","前金區民生里",1,1,0,1,0,1,0,2
10403,"高雄市","前金區青山里",2,2,0,0,0,0,3,0
10403,"高雄市","前金區榮復里",2,1,1,2,1,1,1,0
10403,"高雄市","前金區三川里",1,0,1,0,0,0,1,0
10403,"高雄市","前金區社東里",5,4,1,2,0,2,1,2
10403,"高雄市","前金區社西里",1,0,1,4,2,2,5,0
10403,"高雄市","前金區文東里",0,0,0,3,2,1,1,0
10403,"高雄市","前金區文西里",1,0,1,2,1,1,3,0
10403,"高雄市","前金區新生里",2,1,1,5,2,3,5,1
10403,"高雄市","前金區長城里",1,1,0,5,4,1,3,1
10403,"高雄市","前金區長生里",3,2,1,4,1,3,1,0
10403,"高雄市","前金區長興里",4,3,1,2,0,2,1,0
10403,"高雄市","前鎮區草衙里",12,4,8,11,9,2,11,6
10403,"高雄市","前鎮區德昌里",2,1,1,5,3,2,1,0
10403,"高雄市","前鎮區復國里",5,2,3,7,4,3,2,1
10403,"高雄市","前鎮區建隆里",0,0,0,4,1,3,0,0
10403,"高雄市","前鎮區良和里",1,0,1,3,1,2,3,0
10403,"高雄市","前鎮區民權里",2,2,0,7,5,2,5,3
10403,"高雄市","前鎮區明道里",3,2,1,2,1,1,0,1
10403,"高雄市","前鎮區明禮里",2,1,1,1,1,0,0,1
10403,"高雄市","前鎮區明孝里",2,1,1,4,3,1,3,0
10403,"高雄市","前鎮區明義里",3,0,3,4,2,2,1,0
10403,"高雄市","前鎮區明正里",12,8,4,10,7,3,6,1
10403,"高雄市","前鎮區平昌里",0,0,0,2,2,0,1,0
10403,"高雄市","前鎮區平等里",3,1,2,7,6,1,5,0
10403,"高雄市","前鎮區前鎮里",2,1,1,2,0,2,2,0
10403,"高雄市","前鎮區仁愛里",3,1,2,2,1,1,1,0
10403,"高雄市","前鎮區瑞北里",6,2,4,8,5,3,4,1
10403,"高雄市","前鎮區瑞昌里",5,2,3,6,2,4,4,0
10403,"高雄市","前鎮區瑞誠里",7,2,5,4,4,0,3,1
10403,"高雄市","前鎮區瑞東里",3,3,0,2,0,2,3,1
10403,"高雄市","前鎮區瑞豐里",1,1,0,5,4,1,6,0
10403,"高雄市","前鎮區瑞崗里",5,3,2,2,1,1,3,0
10403,"高雄市","前鎮區瑞和里",3,2,1,3,3,0,0,2
10403,"高雄市","前鎮區瑞華里",8,3,5,9,8,1,5,1
10403,"高雄市","前鎮區瑞隆里",4,2,2,7,4,3,8,6
10403,"高雄市","前鎮區瑞南里",7,2,5,9,4,5,9,1
10403,"高雄市","前鎮區瑞平里",5,1,4,6,4,2,1,0
10403,"高雄市","前鎮區瑞文里",3,1,2,4,4,0,1,2
10403,"高雄市","前鎮區瑞西里",6,2,4,2,1,1,2,1
10403,"高雄市","前鎮區瑞祥里",5,3,2,7,3,4,4,1
10403,"高雄市","前鎮區瑞興里",4,1,3,7,2,5,3,0
10403,"高雄市","前鎮區瑞竹里",3,0,3,3,2,1,5,1
10403,"高雄市","前鎮區盛豐里",5,4,1,3,3,0,4,1
10403,"高雄市","前鎮區盛興里",5,1,4,4,3,1,1,1
10403,"高雄市","前鎮區西甲里",1,0,1,5,3,2,6,0
10403,"高雄市","前鎮區西山里",2,0,2,8,7,1,2,0
10403,"高雄市","前鎮區信德里",2,0,2,3,1,2,4,3
10403,"高雄市","前鎮區信義里",2,1,1,5,3,2,4,0
10403,"高雄市","前鎮區興邦里",6,4,2,4,2,2,5,3
10403,"高雄市","前鎮區興東里",9,7,2,4,3,1,4,3
10403,"高雄市","前鎮區興化里",0,0,0,3,2,1,0,1
10403,"高雄市","前鎮區興仁里",1,1,0,1,0,1,0,0
10403,"高雄市","前鎮區興中里",2,2,0,9,8,1,1,0
10403,"高雄市","前鎮區振興里",4,2,2,2,2,0,3,0
10403,"高雄市","前鎮區鎮北里",1,1,0,2,1,1,2,1
10403,"高雄市","前鎮區鎮昌里",1,1,0,7,6,1,5,0
10403,"高雄市","前鎮區鎮東里",1,1,0,1,1,0,1,1
10403,"高雄市","前鎮區鎮海里",3,2,1,9,7,2,8,1
10403,"高雄市","前鎮區鎮榮里",7,3,4,3,2,1,3,0
10403,"高雄市","前鎮區鎮陽里",2,2,0,2,1,1,2,0
10403,"高雄市","前鎮區鎮中里",1,1,0,3,3,0,4,0
10403,"高雄市","前鎮區忠誠里",3,2,1,9,7,2,5,0
10403,"高雄市","前鎮區忠純里",3,1,2,15,12,3,3,2
10403,"高雄市","前鎮區忠孝里",7,6,1,7,2,5,3,0
10403,"高雄市","前鎮區竹北里",4,3,1,6,5,1,4,2
10403,"高雄市","前鎮區竹東里",4,2,2,4,4,0,7,1
10403,"高雄市","前鎮區竹南里",18,8,10,7,3,4,9,4
10403,"高雄市","前鎮區竹內里",4,3,1,5,2,3,2,2
10403,"高雄市","前鎮區竹西里",5,2,3,6,5,1,2,0
10403,"高雄市","前鎮區竹中里",4,3,1,4,4,0,5,0
10403,"高雄市","橋頭區白樹里",2,0,2,10,7,3,0,1
10403,"高雄市","橋頭區筆秀里",2,0,2,3,2,1,1,0
10403,"高雄市","橋頭區德松里",2,0,2,3,2,1,1,1
10403,"高雄市","橋頭區頂鹽里",5,0,5,3,3,0,3,0
10403,"高雄市","橋頭區東林里",3,1,2,3,2,1,4,0
10403,"高雄市","橋頭區甲北里",1,0,1,3,2,1,1,0
10403,"高雄市","橋頭區甲南里",7,4,3,8,5,3,2,0
10403,"高雄市","橋頭區橋南里",1,1,0,1,0,1,1,0
10403,"高雄市","橋頭區橋頭里",3,2,1,2,1,1,0,0
10403,"高雄市","橋頭區三德里",1,1,0,2,1,1,2,0
10403,"高雄市","橋頭區仕豐里",5,2,3,2,1,1,6,2
10403,"高雄市","橋頭區仕和里",3,1,2,5,1,4,3,3
10403,"高雄市","橋頭區仕隆里",1,1,0,5,5,0,2,0
10403,"高雄市","橋頭區西林里",2,1,1,2,2,0,4,0
10403,"高雄市","橋頭區新莊里",3,0,3,2,2,0,2,1
10403,"高雄市","橋頭區芋寮里",3,3,0,5,2,3,0,1
10403,"高雄市","橋頭區中崎里",1,0,1,0,0,0,1,1
10403,"高雄市","仁武區八卦里",27,13,14,11,6,5,15,7
10403,"高雄市","仁武區赤山里",8,3,5,6,5,1,11,1
10403,"高雄市","仁武區大灣里",11,6,5,4,3,1,6,2
10403,"高雄市","仁武區高楠里",6,2,4,1,0,1,2,1
10403,"高雄市","仁武區後安里",3,1,2,6,5,1,8,0
10403,"高雄市","仁武區考潭里",3,1,2,11,9,2,3,1
10403,"高雄市","仁武區仁慈里",8,3,5,0,0,0,4,1
10403,"高雄市","仁武區仁福里",0,0,0,5,5,0,0,0
10403,"高雄市","仁武區仁和里",8,5,3,2,2,0,6,1
10403,"高雄市","仁武區仁武里",12,7,5,7,4,3,4,4
10403,"高雄市","仁武區灣內里",16,12,4,7,4,3,11,7
10403,"高雄市","仁武區文武里",18,9,9,8,4,4,10,5
10403,"高雄市","仁武區烏林里",9,2,7,10,5,5,9,1
10403,"高雄市","仁武區五和里",9,4,5,5,4,1,9,5
10403,"高雄市","仁武區中華里",2,0,2,2,1,1,0,0
10403,"高雄市","仁武區竹後里",1,1,0,3,2,1,1,0
10403,"高雄市","三民區安邦里",6,4,2,6,5,1,3,0
10403,"高雄市","三民區安東里",3,3,0,3,2,1,6,1
10403,"高雄市","三民區安發里",9,3,6,7,3,4,7,3
10403,"高雄市","三民區安和里",3,2,1,2,1,1,1,1
10403,"高雄市","三民區安吉里",4,2,2,14,7,7,7,5
10403,"高雄市","三民區安康里",0,0,0,6,4,2,2,2
10403,"高雄市","三民區安寧里",0,0,0,3,0,3,2,1
10403,"高雄市","三民區安生里",1,1,0,3,1,2,1,2
10403,"高雄市","三民區安泰里",5,5,0,4,3,1,2,1
10403,"高雄市","三民區安宜里",5,1,4,3,0,3,5,2
10403,"高雄市","三民區寶安里",11,7,4,12,7,5,9,3
10403,"高雄市","三民區寶德里",14,7,7,4,2,2,5,2
10403,"高雄市","三民區寶國里",18,10,8,8,5,3,14,4
10403,"高雄市","三民區寶華里",2,2,0,5,4,1,4,2
10403,"高雄市","三民區寶龍里",7,5,2,3,3,0,5,1
10403,"高雄市","三民區寶民里",10,8,2,1,1,0,5,0
10403,"高雄市","三民區寶慶里",4,2,2,2,1,1,3,1
10403,"高雄市","三民區寶盛里",9,3,6,3,2,1,6,4
10403,"高雄市","三民區寶獅里",7,4,3,1,1,0,4,3
10403,"高雄市","三民區寶泰里",11,6,5,2,2,0,7,1
10403,"高雄市","三民區寶興里",11,7,4,6,4,2,10,2
10403,"高雄市","三民區寶業里",7,5,2,8,5,3,4,3
10403,"高雄市","三民區寶玉里",18,9,9,4,2,2,7,4
10403,"高雄市","三民區寶中里",5,3,2,2,0,2,3,2
10403,"高雄市","三民區寶珠里",14,7,7,14,10,4,5,5
10403,"高雄市","三民區本安里",8,6,2,7,2,5,6,1
10403,"高雄市","三民區本館里",14,10,4,11,7,4,12,3
10403,"高雄市","三民區本和里",14,8,6,7,4,3,7,1
10403,"高雄市","三民區本上里",6,3,3,2,2,0,8,2
10403,"高雄市","三民區本文里",1,1,0,5,3,2,2,0
10403,"高雄市","三民區本武里",5,2,3,0,0,0,2,0
10403,"高雄市","三民區本揚里",12,7,5,8,7,1,5,3
10403,"高雄市","三民區本元里",9,4,5,4,1,3,5,4
10403,"高雄市","三民區博愛里",1,0,1,4,1,3,1,0
10403,"高雄市","三民區博惠里",4,1,3,3,1,2,2,3
10403,"高雄市","三民區川東里",1,1,0,2,1,1,0,0
10403,"高雄市","三民區達德里",2,2,0,3,1,2,0,2
10403,"高雄市","三民區達明里",2,2,0,1,1,0,4,1
10403,"高雄市","三民區達仁里",2,2,0,3,2,1,1,0
10403,"高雄市","三民區達勇里",1,0,1,1,1,0,0,0
10403,"高雄市","三民區德北里",1,0,1,2,2,0,3,3
10403,"高雄市","三民區德東里",0,0,0,0,0,0,0,0
10403,"高雄市","三民區德仁里",1,0,1,2,2,0,0,0
10403,"高雄市","三民區德西里",2,1,1,3,1,2,1,0
10403,"高雄市","三民區德行里",1,0,1,2,2,0,2,0
10403,"高雄市","三民區德智里",7,4,3,0,0,0,4,0
10403,"高雄市","三民區鼎金里",3,3,0,5,3,2,8,2
10403,"高雄市","三民區鼎力里",8,4,4,4,2,2,4,0
10403,"高雄市","三民區鼎強里",5,2,3,3,3,0,8,1
10403,"高雄市","三民區鼎盛里",15,9,6,6,4,2,5,4
10403,"高雄市","三民區鼎泰里",30,13,17,25,19,6,20,13
10403,"高雄市","三民區鼎西里",11,5,6,10,5,5,11,4
10403,"高雄市","三民區鼎中里",7,4,3,6,5,1,3,1
10403,"高雄市","三民區豐裕里",4,1,3,8,4,4,2,0
10403,"高雄市","三民區鳳北里",0,0,0,3,1,2,0,0
10403,"高雄市","三民區鳳南里",1,0,1,2,2,0,1,0
10403,"高雄市","三民區港東里",3,2,1,2,2,0,1,0
10403,"高雄市","三民區港西里",1,0,1,1,1,0,1,0
10403,"高雄市","三民區港新里",3,1,2,1,0,1,1,0
10403,"高雄市","三民區建東里",2,2,0,0,0,0,3,0
10403,"高雄市","三民區精華里",0,0,0,3,3,0,0,0
10403,"高雄市","三民區力行里",0,0,0,2,1,1,3,1
10403,"高雄市","三民區立誠里",1,1,0,4,3,1,0,0
10403,"高雄市","三民區立德里",1,1,0,1,1,0,3,2
10403,"高雄市","三民區立業里",0,0,0,1,0,1,1,1
10403,"高雄市","三民區民享里",4,3,1,3,1,2,4,2
10403,"高雄市","三民區千北里",0,0,0,2,1,1,2,1
10403,"高雄市","三民區千秋里",3,1,2,6,3,3,1,0
10403,"高雄市","三民區千歲里",0,0,0,2,2,0,0,1
10403,"高雄市","三民區十美里",2,1,1,3,2,1,0,0
10403,"高雄市","三民區十全里",4,0,4,5,5,0,2,0
10403,"高雄市","三民區同德里",2,0,2,4,2,2,1,2
10403,"高雄市","三民區灣愛里",4,1,3,4,0,4,4,3
10403,"高雄市","三民區灣成里",2,1,1,2,2,0,3,1
10403,"高雄市","三民區灣復里",13,4,9,6,2,4,6,2
10403,"高雄市","三民區灣華里",3,0,3,4,1,3,5,1
10403,"高雄市","三民區灣利里",5,4,1,5,2,3,4,1
10403,"高雄市","三民區灣勝里",3,2,1,2,2,0,4,0
10403,"高雄市","三民區灣興里",3,3,0,2,0,2,3,1
10403,"高雄市","三民區灣中里",6,3,3,7,4,3,13,3
10403,"高雄市","三民區灣子里",8,3,5,7,2,5,13,3
10403,"高雄市","三民區興德里",1,1,0,3,1,2,1,0
10403,"高雄市","三民區裕民里",2,1,1,0,0,0,0,0
10403,"高雄市","三民區長明里",0,0,0,0,0,0,0,1
10403,"高雄市","三民區正順里",9,3,6,7,6,1,9,1
10403,"高雄市","三民區正興里",25,14,11,18,7,11,19,7
10403,"高雄市","杉林區大愛里",3,2,1,4,1,3,1,2
10403,"高雄市","杉林區集來里",0,0,0,1,1,0,0,1
10403,"高雄市","杉林區木梓里",0,0,0,5,4,1,1,0
10403,"高雄市","杉林區杉林里",1,0,1,6,3,3,0,1
10403,"高雄市","杉林區上平里",1,1,0,9,3,6,0,0
10403,"高雄市","杉林區新庄里",2,1,1,7,3,4,0,2
10403,"高雄市","杉林區月眉里",1,1,0,4,4,0,0,0
10403,"高雄市","杉林區月美里",1,0,1,4,3,1,1,1
10403,"高雄市","桃源區寶山里",1,1,0,0,0,0,0,0
10403,"高雄市","桃源區復興里",0,0,0,0,0,0,1,0
10403,"高雄市","桃源區高中里",2,1,1,1,1,0,0,0
10403,"高雄市","桃源區建山里",2,2,0,3,2,1,1,0
10403,"高雄市","桃源區拉芙蘭里",1,0,1,0,0,0,1,0
10403,"高雄市","桃源區梅山里",0,0,0,0,0,0,1,0
10403,"高雄市","桃源區勤和里",0,0,0,1,1,0,0,0
10403,"高雄市","桃源區桃源里",1,0,1,2,1,1,0,0
10403,"高雄市","田寮區崇德里",1,0,1,5,3,2,1,1
10403,"高雄市","田寮區大同里",0,0,0,1,0,1,0,0
10403,"高雄市","田寮區古亭里",0,0,0,4,3,1,0,0
10403,"高雄市","田寮區鹿埔里",0,0,0,1,1,0,0,0
10403,"高雄市","田寮區南安里",1,0,1,1,1,0,1,0
10403,"高雄市","田寮區七星里",2,1,1,4,2,2,1,0
10403,"高雄市","田寮區三和里",1,0,1,0,0,0,0,0
10403,"高雄市","田寮區田寮里",0,0,0,2,2,0,0,1
10403,"高雄市","田寮區西德里",0,0,0,0,0,0,0,0
10403,"高雄市","田寮區新興里",4,2,2,5,5,0,2,0
10403,"高雄市","小港區大苓里",5,2,3,3,2,1,6,1
10403,"高雄市","小港區大坪里",5,3,2,3,3,0,5,0
10403,"高雄市","小港區店鎮里",10,4,6,4,2,2,6,4
10403,"高雄市","小港區二苓里",4,2,2,9,6,3,7,3
10403,"高雄市","小港區鳳宮里",1,0,1,7,4,3,2,0
10403,"高雄市","小港區鳳林里",3,2,1,9,3,6,3,1
10403,"高雄市","小港區鳳鳴里",2,0,2,6,4,2,3,0
10403,"高雄市","小港區鳳森里",2,1,1,5,3,2,2,2
10403,"高雄市","小港區鳳興里",7,3,4,6,3,3,5,3
10403,"高雄市","小港區鳳源里",4,3,1,1,1,0,1,0
10403,"高雄市","小港區港后里",6,2,4,1,1,0,2,3
10403,"高雄市","小港區港口里",6,3,3,4,3,1,4,2
10403,"高雄市","小港區港明里",4,1,3,4,3,1,6,3
10403,"高雄市","小港區港南里",3,2,1,4,3,1,1,3
10403,"高雄市","小港區港墘里",1,0,1,2,2,0,3,1
10403,"高雄市","小港區港興里",5,2,3,4,3,1,0,3
10403,"高雄市","小港區港正里",1,1,0,1,1,0,4,1
10403,"高雄市","小港區高松里",7,5,2,6,4,2,8,3
10403,"高雄市","小港區桂林里",6,3,3,5,4,1,4,4
10403,"高雄市","小港區合作里",3,2,1,2,2,0,3,1
10403,"高雄市","小港區宏亮里",6,3,3,4,3,1,3,2
10403,"高雄市","小港區濟南里",8,3,5,11,6,5,4,3
10403,"高雄市","小港區孔宅里",6,3,3,4,3,1,9,2
10403,"高雄市","小港區六苓里",5,2,3,2,2,0,2,1
10403,"高雄市","小港區龍鳳里",7,3,4,5,1,4,2,1
10403,"高雄市","小港區坪頂里",22,11,11,5,4,1,9,2
10403,"高雄市","小港區青島里",3,3,0,4,3,1,1,2
10403,"高雄市","小港區三苓里",3,1,2,3,2,1,3,1
10403,"高雄市","小港區廈莊里",4,2,2,2,1,1,4,3
10403,"高雄市","小港區山東里",7,6,1,2,1,1,1,1
10403,"高雄市","小港區山明里",24,10,14,14,8,6,14,5
10403,"高雄市","小港區順苓里",6,3,3,5,3,2,8,4
10403,"高雄市","小港區松金里",2,2,0,5,2,3,5,0
10403,"高雄市","小港區松山里",13,5,8,6,4,2,2,1
10403,"高雄市","小港區泰山里",6,3,3,0,0,0,4,1
10403,"高雄市","小港區小港里",1,1,0,5,3,2,3,1
10403,"高雄市","小港區正苓里",13,6,7,2,2,0,8,2
10403,"高雄市","小港區中厝里",9,7,2,3,3,0,3,1
10403,"高雄市","新興區愛平里",1,0,1,3,1,2,1,0
10403,"高雄市","新興區成功里",1,0,1,2,0,2,0,1
10403,"高雄市","新興區大明里",2,0,2,3,2,1,1,0
10403,"高雄市","新興區德生里",2,0,2,8,5,3,3,0
10403,"高雄市","新興區德望里",2,1,1,4,2,2,1,2
10403,"高雄市","新興區德政里",0,0,0,0,0,0,0,1
10403,"高雄市","新興區東坡里",1,1,0,3,2,1,3,1
10403,"高雄市","新興區光耀里",6,1,5,4,3,1,2,0
10403,"高雄市","新興區漢民里",1,1,0,2,0,2,0,0
10403,"高雄市","新興區浩然里",2,0,2,3,1,2,1,0
10403,"高雄市","新興區華聲里",0,0,0,0,0,0,2,1
10403,"高雄市","新興區建華里",0,0,0,1,0,1,1,0
10403,"高雄市","新興區建興里",1,1,0,1,0,1,3,1
10403,"高雄市","新興區蕉園里",0,0,0,3,2,1,0,1
10403,"高雄市","新興區開平里",6,2,4,3,0,3,5,2
10403,"高雄市","新興區黎明里",1,1,0,2,1,1,2,1
10403,"高雄市","新興區明莊里",0,0,0,0,0,0,0,0
10403,"高雄市","新興區南港里",1,0,1,2,1,1,4,0
10403,"高雄市","新興區秋山里",0,0,0,1,1,0,3,0
10403,"高雄市","新興區仁聲里",0,0,0,0,0,0,1,0
10403,"高雄市","新興區榮治里",0,0,0,1,1,0,1,1
10403,"高雄市","新興區順昌里",3,0,3,3,2,1,0,1
10403,"高雄市","新興區文昌里",3,2,1,3,2,1,2,1
10403,"高雄市","新興區新江里",2,1,1,4,1,3,1,0
10403,"高雄市","新興區興昌里",2,0,2,4,3,1,2,1
10403,"高雄市","新興區永寧里",1,1,0,1,1,0,2,0
10403,"高雄市","新興區玉衡里",0,0,0,3,2,1,0,0
10403,"高雄市","新興區長驛里",1,1,0,3,0,3,1,0
10403,"高雄市","新興區振成里",3,2,1,3,1,2,1,2
10403,"高雄市","新興區振華里",1,0,1,2,1,1,1,0
10403,"高雄市","新興區正氣里",0,0,0,8,5,3,0,2
10403,"高雄市","新興區中東里",4,2,2,3,3,0,0,0
10403,"高雄市","鹽埕區博愛里",0,0,0,1,1,0,1,1
10403,"高雄市","鹽埕區慈愛里",0,0,0,0,0,0,0,0
10403,"高雄市","鹽埕區府北里",2,0,2,5,2,3,2,1
10403,"高雄市","鹽埕區港都里",1,0,1,1,1,0,2,1
10403,"高雄市","鹽埕區光明里",0,0,0,3,1,2,3,0
10403,"高雄市","鹽埕區河濱里",2,1,1,3,2,1,4,0
10403,"高雄市","鹽埕區江南里",1,0,1,1,1,0,0,0
10403,"高雄市","鹽埕區江西里",1,1,0,2,0,2,1,1
10403,"高雄市","鹽埕區教仁里",5,2,3,5,2,3,4,0
10403,"高雄市","鹽埕區瀨南里",0,0,0,4,2,2,1,0
10403,"高雄市","鹽埕區藍橋里",5,2,3,2,1,1,4,2
10403,"高雄市","鹽埕區陸橋里",0,0,0,2,2,0,0,2
10403,"高雄市","鹽埕區南端里",0,0,0,3,2,1,1,0
10403,"高雄市","鹽埕區沙地里",0,0,0,1,1,0,1,0
10403,"高雄市","鹽埕區壽星里",2,2,0,4,2,2,3,1
10403,"高雄市","鹽埕區新豐里",0,0,0,3,1,2,1,2
10403,"高雄市","鹽埕區新化里",2,0,2,0,0,0,0,0
10403,"高雄市","鹽埕區新樂里",1,1,0,1,0,1,3,1
10403,"高雄市","鹽埕區育仁里",1,0,1,0,0,0,2,2
10403,"高雄市","鹽埕區中山里",1,1,0,2,1,1,0,0
10403,"高雄市","鹽埕區中原里",1,1,0,0,0,0,1,0
10403,"高雄市","燕巢區安招里",4,1,3,22,21,1,6,3
10403,"高雄市","燕巢區東燕里",2,1,1,5,2,3,2,0
10403,"高雄市","燕巢區鳳雄里",3,3,0,10,5,5,2,1
10403,"高雄市","燕巢區橫山里",4,3,1,7,4,3,0,0
10403,"高雄市","燕巢區尖山里",4,1,3,3,1,2,0,0
10403,"高雄市","燕巢區角宿里",3,1,2,2,1,1,3,1
10403,"高雄市","燕巢區金山里",3,2,1,2,0,2,2,0
10403,"高雄市","燕巢區南燕里",4,3,1,6,3,3,3,2
10403,"高雄市","燕巢區瓊林里",3,0,3,2,0,2,2,0
10403,"高雄市","燕巢區深水里",4,3,1,13,8,5,2,2
10403,"高雄市","燕巢區西燕里",3,2,1,5,3,2,1,1
10403,"高雄市","永安區保寧里",5,4,1,6,4,2,4,2
10403,"高雄市","永安區維新里",11,7,4,5,1,4,5,2
10403,"高雄市","永安區新港里",6,1,5,8,7,1,3,2
10403,"高雄市","永安區鹽田里",3,1,2,0,0,0,0,0
10403,"高雄市","永安區永安里",1,0,1,2,2,0,4,0
10403,"高雄市","永安區永華里",7,2,5,2,1,1,2,1
10403,"高雄市","梓官區赤東里",2,2,0,3,2,1,3,1
10403,"高雄市","梓官區赤崁里",4,2,2,1,0,1,4,2
10403,"高雄市","梓官區赤西里",0,0,0,0,0,0,0,1
10403,"高雄市","梓官區大舍里",7,3,4,7,5,2,4,3
10403,"高雄市","梓官區典寶里",8,5,3,2,2,0,2,3
10403,"高雄市","梓官區茄苳里",4,4,0,2,1,1,4,0
10403,"高雄市","梓官區禮蚵里",1,1,0,4,2,2,1,2
10403,"高雄市","梓官區同安里",0,0,0,1,1,0,0,0
10403,"高雄市","梓官區信蚵里",7,4,3,4,2,2,4,1
10403,"高雄市","梓官區智蚵里",5,2,3,6,2,4,3,0
10403,"高雄市","梓官區中崙里",2,1,1,2,1,1,0,1
10403,"高雄市","梓官區梓和里",4,3,1,4,3,1,2,1
10403,"高雄市","梓官區梓平里",3,1,2,2,2,0,1,0
10403,"高雄市","梓官區梓信里",3,2,1,2,1,1,1,0
10403,"高雄市","梓官區梓義里",1,1,0,3,1,2,3,2
10403,"高雄市","左營區菜公里",53,32,21,25,17,8,27,11
10403,"高雄市","左營區城南里",0,0,0,4,2,2,1,0
10403,"高雄市","左營區崇實里",12,8,4,2,0,2,10,5
10403,"高雄市","左營區頂北里",0,0,0,2,1,1,0,0
10403,"高雄市","左營區頂西里",3,2,1,4,2,2,3,0
10403,"高雄市","左營區福山里",71,41,30,22,14,8,60,17
10403,"高雄市","左營區光輝里",2,1,1,3,1,2,5,0
10403,"高雄市","左營區果峰里",1,1,0,6,6,0,4,1
10403,"高雄市","左營區果惠里",1,0,1,3,2,1,3,0
10403,"高雄市","左營區果貿里",5,4,1,11,5,6,1,4
10403,"高雄市","左營區海勝里",5,5,0,20,13,7,5,3
10403,"高雄市","左營區合群里",2,1,1,11,6,5,3,0
10403,"高雄市","左營區進學里",2,0,2,3,3,0,1,0
10403,"高雄市","左營區莒光里",3,2,1,6,4,2,4,2
10403,"高雄市","左營區路東里",0,0,0,2,1,1,0,1
10403,"高雄市","左營區廟北里",1,1,0,0,0,0,0,2
10403,"高雄市","左營區廟東里",0,0,0,3,3,0,0,1
10403,"高雄市","左營區明建里",3,2,1,0,0,0,1,0
10403,"高雄市","左營區埤北里",2,1,1,8,4,4,1,0
10403,"高雄市","左營區埤東里",1,0,1,5,3,2,2,0
10403,"高雄市","左營區埤西里",1,0,1,1,1,0,0,0
10403,"高雄市","左營區屏山里",1,1,0,2,2,0,3,3
10403,"高雄市","左營區廍北里",0,0,0,1,1,0,0,1
10403,"高雄市","左營區廍南里",2,1,1,4,3,1,3,0
10403,"高雄市","左營區聖后里",2,2,0,1,0,1,2,0
10403,"高雄市","左營區聖南里",2,1,1,2,1,1,1,0
10403,"高雄市","左營區聖西里",0,0,0,2,1,1,0,1
10403,"高雄市","左營區尾北里",0,0,0,6,4,2,3,5
10403,"高雄市","左營區尾南里",0,0,0,1,0,1,2,0
10403,"高雄市","左營區尾西里",1,1,0,2,1,1,1,0
10403,"高雄市","左營區祥和里",0,0,0,1,1,0,1,0
10403,"高雄市","左營區新光里",17,9,8,7,6,1,12,10
10403,"高雄市","左營區新上里",36,21,15,29,14,15,24,14
10403,"高雄市","左營區新下里",27,16,11,12,5,7,17,10
10403,"高雄市","左營區新中里",5,3,2,2,2,0,2,1
10403,"高雄市","左營區永清里",5,1,4,1,0,1,0,0
10403,"高雄市","左營區中北里",1,1,0,3,1,2,0,0
10403,"高雄市","左營區中南里",0,0,0,1,1,0,2,1
10403,"高雄市","左營區自助里",0,0,0,3,2,1,0,0
10405,"高雄市","阿蓮區阿蓮里",8,5,3,5,3,2,11,1
10405,"高雄市","阿蓮區峯山里",1,0,1,4,4,0,2,0
10405,"高雄市","阿蓮區復安里",2,1,1,2,0,2,0,0
10405,"高雄市","阿蓮區崗山里",0,0,0,2,1,1,3,1
10405,"高雄市","阿蓮區港後里",4,3,1,7,6,1,4,4
10405,"高雄市","阿蓮區和蓮里",2,1,1,4,2,2,2,1
10405,"高雄市","阿蓮區南蓮里",3,3,0,7,4,3,4,2
10405,"高雄市","阿蓮區青旗里",0,0,0,6,4,2,1,1
10405,"高雄市","阿蓮區清蓮里",2,0,2,5,2,3,7,1
10405,"高雄市","阿蓮區石安里",1,1,0,5,2,3,1,0
10405,"高雄市","阿蓮區玉庫里",0,0,0,2,1,1,1,1
10405,"高雄市","阿蓮區中路里",2,1,1,2,1,1,2,1
10405,"高雄市","大寮區潮寮里",5,3,2,3,1,2,3,0
10405,"高雄市","大寮區大寮里",11,3,8,10,8,2,7,1
10405,"高雄市","大寮區光武里",0,0,0,1,1,0,0,1
10405,"高雄市","大寮區過溪里",3,2,1,4,3,1,3,2
10405,"高雄市","大寮區後庄里",12,6,6,7,0,7,10,2
10405,"高雄市","大寮區會結里",4,2,2,2,1,1,3,2
10405,"高雄市","大寮區會社里",16,6,10,13,8,5,6,2
10405,"高雄市","大寮區江山里",8,3,5,6,3,3,2,0
10405,"高雄市","大寮區拷潭里",2,0,2,0,0,0,4,0
10405,"高雄市","大寮區琉球里",11,1,10,4,4,0,5,3
10405,"高雄市","大寮區內坑里",5,3,2,10,9,1,10,2
10405,"高雄市","大寮區前庄里",4,2,2,4,3,1,4,0
10405,"高雄市","大寮區三隆里",4,3,1,13,9,4,11,1
10405,"高雄市","大寮區山頂里",10,4,6,8,5,3,12,10
10405,"高雄市","大寮區上寮里",2,0,2,6,3,3,4,0
10405,"高雄市","大寮區翁園里",8,3,5,7,5,2,4,1
10405,"高雄市","大寮區溪寮里",2,2,0,1,0,1,0,0
10405,"高雄市","大寮區新厝里",2,1,1,7,6,1,1,1
10405,"高雄市","大寮區義和里",2,2,0,4,4,0,1,1
10405,"高雄市","大寮區義仁里",1,0,1,3,1,2,1,0
10405,"高雄市","大寮區永芳里",14,5,9,11,5,6,11,2
10405,"高雄市","大寮區昭明里",10,8,2,7,4,3,3,0
10405,"高雄市","大寮區中興里",12,2,10,18,11,7,6,1
10405,"高雄市","大寮區中庄里",13,6,7,16,7,9,15,10
10405,"高雄市","大寮區忠義里",0,0,0,1,0,1,0,0
10405,"高雄市","大社區保安里",7,3,4,2,1,1,5,2
10405,"高雄市","大社區保社里",1,0,1,4,3,1,5,3
10405,"高雄市","大社區翠屏里",1,0,1,2,1,1,3,1
10405,"高雄市","大社區大社里",10,3,7,8,6,2,13,1
10405,"高雄市","大社區觀音里",10,6,4,12,4,8,12,1
10405,"高雄市","大社區嘉誠里",2,1,1,1,0,1,2,1
10405,"高雄市","大社區三奶里",3,2,1,2,0,2,5,3
10405,"高雄市","大社區神農里",10,3,7,5,2,3,5,3
10405,"高雄市","大社區中里里",3,1,2,5,3,2,4,1
10405,"高雄市","大樹區大坑里",1,0,1,3,2,1,7,1
10405,"高雄市","大樹區大樹里",3,1,2,4,2,2,1,1
10405,"高雄市","大樹區姑山里",1,1,0,1,0,1,2,0
10405,"高雄市","大樹區和山里",2,1,1,0,0,0,1,1
10405,"高雄市","大樹區井腳里",2,1,1,2,1,1,4,0
10405,"高雄市","大樹區九曲里",13,7,6,9,6,3,2,0
10405,"高雄市","大樹區久堂里",6,4,2,10,5,5,3,2
10405,"高雄市","大樹區龍目里",2,2,0,3,1,2,0,0
10405,"高雄市","大樹區三和里",0,0,0,3,0,3,0,0
10405,"高雄市","大樹區檨腳里",4,3,1,7,4,3,6,1
10405,"高雄市","大樹區水安里",3,0,3,5,3,2,6,0
10405,"高雄市","大樹區水寮里",4,2,2,4,3,1,0,1
10405,"高雄市","大樹區統嶺里",1,1,0,3,2,1,1,0
10405,"高雄市","大樹區溪埔里",2,2,0,4,4,0,2,0
10405,"高雄市","大樹區小坪里",4,4,0,4,2,2,2,0
10405,"高雄市","大樹區興山里",1,0,1,3,1,2,2,1
10405,"高雄市","大樹區興田里",3,0,3,1,1,0,1,3
10405,"高雄市","大樹區竹寮里",3,1,2,4,2,2,4,2
10405,"高雄市","鳳山區保安里",26,16,10,1,1,0,16,2
10405,"高雄市","鳳山區北門里",2,1,1,4,1,3,8,1
10405,"高雄市","鳳山區曹公里",1,0,1,6,4,2,3,1
10405,"高雄市","鳳山區成功里",0,0,0,2,1,1,1,0
10405,"高雄市","鳳山區誠德里",4,1,3,4,4,0,2,3
10405,"高雄市","鳳山區誠信里",3,3,0,2,1,1,1,0
10405,"高雄市","鳳山區誠義里",7,2,5,4,2,2,8,1
10405,"高雄市","鳳山區誠智里",2,2,0,2,0,2,3,1
10405,"高雄市","鳳山區大德里",8,6,2,7,3,4,7,1
10405,"高雄市","鳳山區東門里",7,7,0,11,7,4,8,3
10405,"高雄市","鳳山區二甲里",11,6,5,6,0,6,2,0
10405,"高雄市","鳳山區鳳東里",13,7,6,5,2,3,10,3
10405,"高雄市","鳳山區鳳崗里",2,2,0,5,2,3,2,0
10405,"高雄市","鳳山區福誠里",7,5,2,5,2,3,5,3
10405,"高雄市","鳳山區福祥里",2,2,0,2,0,2,8,1
10405,"高雄市","鳳山區福興里",13,6,7,6,2,4,10,2
10405,"高雄市","鳳山區富甲里",2,2,0,2,1,1,2,0
10405,"高雄市","鳳山區富榮里",7,4,3,2,0,2,5,0
10405,"高雄市","鳳山區光明里",0,0,0,1,1,0,2,0
10405,"高雄市","鳳山區國富里",6,3,3,5,2,3,1,0
10405,"高雄市","鳳山區國光里",2,1,1,1,1,0,7,0
10405,"高雄市","鳳山區國隆里",3,0,3,5,4,1,5,1
10405,"高雄市","鳳山區國泰里",3,2,1,7,5,2,9,1
10405,"高雄市","鳳山區過埤里",32,18,14,11,6,5,23,5
10405,"高雄市","鳳山區海光里",3,2,1,6,3,3,8,0
10405,"高雄市","鳳山區海洋里",8,4,4,6,4,2,2,1
10405,"高雄市","鳳山區和德里",5,1,4,2,2,0,1,1
10405,"高雄市","鳳山區和興里",9,6,3,5,1,4,6,1
10405,"高雄市","鳳山區老爺里",9,4,5,8,5,3,15,4
10405,"高雄市","鳳山區龍成里",5,2,3,2,1,1,4,3
10405,"高雄市","鳳山區南成里",10,3,7,8,5,3,9,2
10405,"高雄市","鳳山區南和里",4,2,2,3,2,1,1,2
10405,"高雄市","鳳山區南興里",2,1,1,1,1,0,2,0
10405,"高雄市","鳳山區埤頂里",14,8,6,11,8,3,9,5
10405,"高雄市","鳳山區瑞興里",5,1,4,8,5,3,7,0
10405,"高雄市","鳳山區瑞竹里",5,3,2,13,7,6,9,4
10405,"高雄市","鳳山區三民里",1,1,0,1,1,0,5,1
10405,"高雄市","鳳山區善美里",9,6,3,5,2,3,8,3
10405,"高雄市","鳳山區生明里",5,3,2,3,2,1,6,0
10405,"高雄市","鳳山區天興里",5,1,4,4,3,1,4,4
10405,"高雄市","鳳山區文德里",13,6,7,6,6,0,18,5
10405,"高雄市","鳳山區文福里",16,8,8,11,8,3,20,3
10405,"高雄市","鳳山區文衡里",7,1,6,3,2,1,12,1
10405,"高雄市","鳳山區文華里",14,6,8,12,5,7,10,4
10405,"高雄市","鳳山區文山里",14,8,6,6,5,1,10,1
10405,"高雄市","鳳山區文英里",7,4,3,1,1,0,5,0
10405,"高雄市","鳳山區五福里",5,4,1,3,2,1,4,1
10405,"高雄市","鳳山區武漢里",10,4,6,9,5,4,3,0
10405,"高雄市","鳳山區武慶里",3,3,0,3,3,0,2,2
10405,"高雄市","鳳山區武松里",3,2,1,5,4,1,5,2
10405,"高雄市","鳳山區縣口里",0,0,0,0,0,0,0,0
10405,"高雄市","鳳山區縣衙里",0,0,0,2,2,0,2,1
10405,"高雄市","鳳山區協和里",2,2,0,8,4,4,3,1
10405,"高雄市","鳳山區新富里",5,3,2,2,1,1,10,2
10405,"高雄市","鳳山區新甲里",6,4,2,8,5,3,4,3
10405,"高雄市","鳳山區新樂里",4,2,2,1,0,1,7,1
10405,"高雄市","鳳山區新強里",7,4,3,7,5,2,6,1
10405,"高雄市","鳳山區新泰里",11,7,4,3,1,2,5,4
10405,"高雄市","鳳山區新武里",2,0,2,4,2,2,4,1
10405,"高雄市","鳳山區新興里",3,0,3,9,5,4,1,0
10405,"高雄市","鳳山區興仁里",4,2,2,3,1,2,0,2
10405,"高雄市","鳳山區興中里",2,0,2,1,1,0,2,0
10405,"高雄市","鳳山區一甲里",1,1,0,9,7,2,6,3
10405,"高雄市","鳳山區鎮北里",14,5,9,10,5,5,12,5
10405,"高雄市","鳳山區鎮東里",1,1,0,5,4,1,3,3
10405,"高雄市","鳳山區鎮南里",4,3,1,7,5,2,8,2
10405,"高雄市","鳳山區鎮西里",7,4,3,4,3,1,8,1
10405,"高雄市","鳳山區正義里",12,8,4,3,2,1,7,4
10405,"高雄市","鳳山區中和里",4,2,2,7,4,3,2,1
10405,"高雄市","鳳山區中崙里",3,3,0,2,2,0,7,0
10405,"高雄市","鳳山區中民里",4,2,2,7,4,3,7,2
10405,"高雄市","鳳山區中榮里",10,3,7,4,4,0,5,4
10405,"高雄市","鳳山區中正里",2,1,1,10,7,3,7,1
10405,"高雄市","鳳山區忠誠里",4,0,4,5,4,1,7,0
10405,"高雄市","鳳山區忠孝里",6,1,5,7,5,2,9,2
10405,"高雄市","鳳山區忠義里",5,1,4,7,2,5,4,0
10405,"高雄市","岡山區白米里",4,3,1,4,3,1,1,3
10405,"高雄市","岡山區本洲里",1,1,0,4,3,1,2,0
10405,"高雄市","岡山區碧紅里",6,1,5,4,1,3,7,1
10405,"高雄市","岡山區程香里",8,4,4,1,1,0,7,2
10405,"高雄市","岡山區大遼里",0,0,0,1,0,1,1,2
10405,"高雄市","岡山區大莊里",4,1,3,3,2,1,2,1
10405,"高雄市","岡山區福興里",2,1,1,2,0,2,4,0
10405,"高雄市","岡山區岡山里",9,5,4,7,6,1,6,2
10405,"高雄市","岡山區和平里",0,0,0,0,0,0,1,0
10405,"高雄市","岡山區後紅里",7,4,3,2,2,0,1,2
10405,"高雄市","岡山區後協里",11,4,7,8,4,4,4,4
10405,"高雄市","岡山區華崗里",0,0,0,6,1,5,0,0
10405,"高雄市","岡山區嘉峰里",4,1,3,0,0,0,6,3
10405,"高雄市","岡山區嘉興里",10,2,8,3,2,1,4,1
10405,"高雄市","岡山區劉厝里",2,1,1,1,1,0,3,0
10405,"高雄市","岡山區平安里",2,1,1,1,0,1,3,0
10405,"高雄市","岡山區前峰里",1,1,0,2,1,1,6,2
10405,"高雄市","岡山區仁壽里",3,0,3,7,6,1,2,1
10405,"高雄市","岡山區仁義里",2,2,0,9,3,6,0,1
10405,"高雄市","岡山區三和里",3,2,1,3,2,1,2,0
10405,"高雄市","岡山區石潭里",3,3,0,2,0,2,2,0
10405,"高雄市","岡山區壽峰里",3,2,1,3,2,1,3,1
10405,"高雄市","岡山區壽天里",5,3,2,6,2,4,10,1
10405,"高雄市","岡山區台上里",12,8,4,11,10,1,11,5
10405,"高雄市","岡山區潭底里",1,1,0,4,1,3,1,0
10405,"高雄市","岡山區灣裡里",3,2,1,1,0,1,2,2
10405,"高雄市","岡山區維仁里",2,2,0,1,1,0,0,0
10405,"高雄市","岡山區為隨里",2,0,2,3,2,1,0,0
10405,"高雄市","岡山區協和里",5,3,2,3,2,1,4,1
10405,"高雄市","岡山區協榮里",4,3,1,3,3,0,1,1
10405,"高雄市","岡山區信義里",2,1,1,1,0,1,0,0
10405,"高雄市","岡山區忠孝里",4,2,2,5,3,2,2,1
10405,"高雄市","岡山區竹圍里",11,6,5,8,3,5,5,2
10405,"高雄市","鼓山區寶樹里",0,0,0,2,1,1,1,3
10405,"高雄市","鼓山區登山里",1,1,0,1,0,1,1,0
10405,"高雄市","鼓山區峰南里",0,0,0,1,1,0,0,1
10405,"高雄市","鼓山區鼓峰里",0,0,0,7,5,2,1,0
10405,"高雄市","鼓山區鼓岩里",3,1,2,7,3,4,0,1
10405,"高雄市","鼓山區光化里",2,0,2,2,2,0,1,1
10405,"高雄市","鼓山區光榮里",4,3,1,8,5,3,2,1
10405,"高雄市","鼓山區河邊里",2,0,2,2,2,0,1,0
10405,"高雄市","鼓山區厚生里",6,3,3,1,1,0,8,2
10405,"高雄市","鼓山區華豐里",6,5,1,3,0,3,0,5
10405,"高雄市","鼓山區惠安里",2,1,1,2,1,1,2,0
10405,"高雄市","鼓山區建國里",1,0,1,4,3,1,4,0
10405,"高雄市","鼓山區麗興里",2,1,1,4,1,3,1,0
10405,"高雄市","鼓山區龍井里",2,2,0,3,3,0,2,0
10405,"高雄市","鼓山區龍水里",48,26,22,10,5,5,27,15
10405,"高雄市","鼓山區龍子里",26,13,13,14,11,3,20,7
10405,"高雄市","鼓山區綠川里",1,1,0,3,1,2,3,0
10405,"高雄市","鼓山區民強里",3,2,1,3,2,1,2,2
10405,"高雄市","鼓山區民族里",0,0,0,1,0,1,1,0
10405,"高雄市","鼓山區明誠里",24,12,12,16,7,9,24,4
10405,"高雄市","鼓山區內惟里",1,1,0,1,1,0,0,1
10405,"高雄市","鼓山區平和里",5,2,3,2,1,1,3,1
10405,"高雄市","鼓山區前峰里",5,2,3,6,2,4,7,1
10405,"高雄市","鼓山區山下里",1,0,1,3,2,1,1,0
10405,"高雄市","鼓山區哨船頭里",0,0,0,1,1,0,2,0
10405,"高雄市","鼓山區壽山里",0,0,0,2,2,0,3,0
10405,"高雄市","鼓山區樹德里",3,2,1,4,2,2,3,1
10405,"高雄市","鼓山區桃源里",1,1,0,2,2,0,0,0
10405,"高雄市","鼓山區維生里",2,1,1,2,2,0,1,0
10405,"高雄市","鼓山區新民里",3,2,1,4,4,0,2,0
10405,"高雄市","鼓山區興宗里",0,0,0,3,2,1,2,0
10405,"高雄市","鼓山區雄峰里",2,2,0,5,4,1,4,2
10405,"高雄市","鼓山區延平里",0,0,0,1,0,1,0,1
10405,"高雄市","鼓山區裕豐里",4,3,1,4,2,2,4,4
10405,"高雄市","鼓山區裕興里",4,2,2,4,3,1,12,2
10405,"高雄市","鼓山區正德里",2,1,1,2,1,1,9,1
10405,"高雄市","鼓山區忠正里",3,2,1,5,3,2,4,1
10405,"高雄市","鼓山區自強里",0,0,0,1,1,0,1,1
10405,"高雄市","湖內區大湖里",9,6,3,6,3,3,3,1
10405,"高雄市","湖內區公舘里",4,1,3,1,0,1,3,2
10405,"高雄市","湖內區海埔里",2,1,1,5,4,1,3,0
10405,"高雄市","湖內區海山里",1,1,0,2,1,1,2,0
10405,"高雄市","湖內區湖東里",3,1,2,1,1,0,1,1
10405,"高雄市","湖內區湖內里",8,5,3,8,3,5,4,1
10405,"高雄市","湖內區劉家里",2,2,0,0,0,0,2,0
10405,"高雄市","湖內區太爺里",0,0,0,2,0,2,1,1
10405,"高雄市","湖內區田尾里",1,1,0,3,2,1,1,0
10405,"高雄市","湖內區文賢里",1,0,1,0,0,0,1,1
10405,"高雄市","湖內區葉厝里",7,4,3,2,1,1,6,0
10405,"高雄市","湖內區逸賢里",1,1,0,4,2,2,2,1
10405,"高雄市","湖內區中賢里",4,3,1,1,0,1,2,0
10405,"高雄市","湖內區忠興里",0,0,0,0,0,0,0,1
10405,"高雄市","茄萣區白雲里",4,2,2,0,0,0,5,0
10405,"高雄市","茄萣區保定里",3,2,1,7,4,3,3,2
10405,"高雄市","茄萣區大定里",0,0,0,2,0,2,1,0
10405,"高雄市","茄萣區福德里",0,0,0,2,2,0,0,0
10405,"高雄市","茄萣區光定里",1,0,1,1,0,1,1,1
10405,"高雄市","茄萣區和協里",1,1,0,2,1,1,1,1
10405,"高雄市","茄萣區吉定里",1,0,1,2,1,1,1,0
10405,"高雄市","茄萣區嘉安里",1,1,0,2,2,0,0,0
10405,"高雄市","茄萣區嘉賜里",4,1,3,6,2,4,3,0
10405,"高雄市","茄萣區嘉定里",1,1,0,1,1,0,2,0
10405,"高雄市","茄萣區嘉福里",1,0,1,1,1,0,2,0
10405,"高雄市","茄萣區嘉樂里",1,1,0,0,0,0,2,0
10405,"高雄市","茄萣區嘉泰里",2,0,2,4,4,0,1,0
10405,"高雄市","茄萣區崎漏里",3,2,1,10,7,3,4,5
10405,"高雄市","茄萣區萬福里",0,0,0,1,0,1,0,2
10405,"高雄市","甲仙區寶隆里",2,2,0,2,1,1,0,1
10405,"高雄市","甲仙區大田里",1,0,1,6,4,2,2,1
10405,"高雄市","甲仙區東安里",0,0,0,3,1,2,2,1
10405,"高雄市","甲仙區關山里",0,0,0,4,2,2,3,0
10405,"高雄市","甲仙區和安里",0,0,0,0,0,0,1,0
10405,"高雄市","甲仙區西安里",3,2,1,2,2,0,0,0
10405,"高雄市","甲仙區小林里",0,0,0,1,0,1,0,0
10405,"高雄市","林園區北汕里",2,2,0,3,1,2,2,0
10405,"高雄市","林園區頂厝里",8,3,5,3,2,1,6,3
10405,"高雄市","林園區東林里",1,0,1,6,5,1,5,2
10405,"高雄市","林園區東汕里",3,2,1,3,1,2,1,1
10405,"高雄市","林園區鳳芸里",2,2,0,4,3,1,5,0
10405,"高雄市","林園區港埔里",5,2,3,9,4,5,2,1
10405,"高雄市","林園區港嘴里",2,1,1,5,3,2,1,0
10405,"高雄市","林園區龔厝里",3,2,1,5,2,3,2,2
10405,"高雄市","林園區廣應里",7,3,4,4,4,0,1,1
10405,"高雄市","林園區林家里",0,0,0,5,3,2,2,1
10405,"高雄市","林園區林內里",1,0,1,4,3,1,1,0
10405,"高雄市","林園區林園里",5,3,2,3,0,3,3,2
10405,"高雄市","林園區仁愛里",4,1,3,4,2,2,3,0
10405,"高雄市","林園區潭頭里",4,3,1,7,7,0,5,0
10405,"高雄市","林園區王公里",6,3,3,5,2,3,4,2
10405,"高雄市","林園區文賢里",0,0,0,0,0,0,6,1
10405,"高雄市","林園區五福里",2,0,2,5,4,1,2,0
10405,"高雄市","林園區溪州里",1,1,0,6,4,2,5,2
10405,"高雄市","林園區西汕里",0,0,0,3,3,0,0,0
10405,"高雄市","林園區西溪里",11,4,7,4,3,1,7,1
10405,"高雄市","林園區中厝里",1,0,1,6,6,0,5,1
10405,"高雄市","林園區中門里",2,1,1,5,2,3,2,1
10405,"高雄市","林園區中汕里",2,1,1,4,3,1,2,1
10405,"高雄市","林園區中芸里",3,1,2,6,4,2,3,0
10405,"高雄市","苓雅區安祥里",2,1,1,2,2,0,1,0
10405,"高雄市","苓雅區博仁里",1,1,0,1,0,1,1,1
10405,"高雄市","苓雅區朝陽里",2,1,1,3,2,1,1,2
10405,"高雄市","苓雅區城北里",0,0,0,1,0,1,1,0
10405,"高雄市","苓雅區城東里",2,2,0,2,1,1,4,2
10405,"高雄市","苓雅區城西里",1,0,1,0,0,0,0,0
10405,"高雄市","苓雅區福地里",6,1,5,7,4,3,2,2
10405,"高雄市","苓雅區福東里",5,2,3,4,2,2,6,1
10405,"高雄市","苓雅區福海里",0,0,0,1,1,0,2,0
10405,"高雄市","苓雅區福居里",1,0,1,1,0,1,5,1
10405,"高雄市","苓雅區福康里",2,0,2,4,4,0,3,1
10405,"高雄市","苓雅區福隆里",7,5,2,4,2,2,7,1
10405,"高雄市","苓雅區福南里",2,1,1,3,1,2,0,1
10405,"高雄市","苓雅區福人里",1,0,1,2,2,0,1,3
10405,"高雄市","苓雅區福壽里",2,1,1,4,4,0,1,0
10405,"高雄市","苓雅區福西里",1,0,1,0,0,0,4,1
10405,"高雄市","苓雅區福祥里",2,1,1,1,0,1,4,1
10405,"高雄市","苓雅區鼓中里",1,0,1,2,0,2,2,0
10405,"高雄市","苓雅區光華里",1,1,0,2,2,0,1,0
10405,"高雄市","苓雅區廣澤里",4,2,2,7,4,3,3,0
10405,"高雄市","苓雅區和煦里",3,0,3,2,2,0,2,1
10405,"高雄市","苓雅區華堂里",2,1,1,6,4,2,6,0
10405,"高雄市","苓雅區建軍里",1,1,0,2,1,1,3,1
10405,"高雄市","苓雅區凱旋里",7,5,2,3,2,1,0,0
10405,"高雄市","苓雅區林安里",3,1,2,2,0,2,2,0
10405,"高雄市","苓雅區林德里",2,0,2,1,1,0,3,0
10405,"高雄市","苓雅區林富里",4,0,4,3,3,0,3,1
10405,"高雄市","苓雅區林貴里",5,5,0,2,2,0,2,0
10405,"高雄市","苓雅區林華里",3,2,1,5,2,3,2,0
10405,"高雄市","苓雅區林靖里",0,0,0,3,1,2,1,0
10405,"高雄市","苓雅區林南里",2,2,0,1,0,1,3,1
10405,"高雄市","苓雅區林泉里",3,3,0,2,2,0,3,1
10405,"高雄市","苓雅區林榮里",3,2,1,8,2,6,7,2
10405,"高雄市","苓雅區林圍里",2,1,1,2,0,2,4,0
10405,"高雄市","苓雅區林西里",1,1,0,0,0,0,4,0
10405,"高雄市","苓雅區林興里",2,2,0,4,2,2,1,1
10405,"高雄市","苓雅區林中里",2,1,1,8,5,3,6,1
10405,"高雄市","苓雅區苓東里",0,0,0,1,1,0,4,0
10405,"高雄市","苓雅區苓昇里",2,2,0,1,1,0,3,0
10405,"高雄市","苓雅區苓雅里",1,1,0,2,2,0,1,0
10405,"高雄市","苓雅區苓中里",0,0,0,2,1,1,5,1
10405,"高雄市","苓雅區苓洲里",1,1,0,4,1,3,3,0
10405,"高雄市","苓雅區美田里",1,0,1,2,1,1,3,0
10405,"高雄市","苓雅區民主里",5,2,3,5,3,2,4,2
10405,"高雄市","苓雅區普天里",6,3,3,5,4,1,3,0
10405,"高雄市","苓雅區普照里",3,2,1,8,0,8,1,2
10405,"高雄市","苓雅區晴朗里",1,0,1,2,0,2,1,1
10405,"高雄市","苓雅區人和里",4,2,2,1,1,0,1,2
10405,"高雄市","苓雅區仁政里",1,0,1,2,1,1,0,0
10405,"高雄市","苓雅區日中里",3,2,1,4,2,2,3,0
10405,"高雄市","苓雅區尚義里",5,2,3,3,2,1,1,0
10405,"高雄市","苓雅區田西里",2,2,0,1,0,1,3,0
10405,"高雄市","苓雅區同慶里",4,2,2,3,1,2,2,2
10405,"高雄市","苓雅區衛武里",1,0,1,4,3,1,0,0
10405,"高雄市","苓雅區文昌里",5,0,5,5,3,2,4,3
10405,"高雄市","苓雅區五福里",3,0,3,2,1,1,8,0
10405,"高雄市","苓雅區五權里",5,3,2,5,3,2,2,0
10405,"高雄市","苓雅區意誠里",5,3,2,7,4,3,3,0
10405,"高雄市","苓雅區英明里",3,0,3,1,0,1,0,1
10405,"高雄市","苓雅區永康里",5,2,3,6,4,2,2,2
10405,"高雄市","苓雅區正大里",10,6,4,10,5,5,10,3
10405,"高雄市","苓雅區正道里",5,3,2,4,3,1,8,0
10405,"高雄市","苓雅區正仁里",2,1,1,4,3,1,6,1
10405,"高雄市","苓雅區正文里",1,0,1,1,1,0,1,1
10405,"高雄市","苓雅區正心里",5,2,3,7,4,3,7,0
10405,"高雄市","苓雅區正言里",8,4,4,7,4,3,6,2
10405,"高雄市","苓雅區正義里",6,1,5,2,0,2,2,0
10405,"高雄市","苓雅區中正里",6,1,5,2,2,0,3,2
10405,"高雄市","苓雅區奏捷里",1,0,1,4,1,3,1,0
10405,"高雄市","六龜區寶來里",4,1,3,2,1,1,0,0
10405,"高雄市","六龜區大津里",0,0,0,0,0,0,1,2
10405,"高雄市","六龜區荖濃里",3,3,0,8,5,3,1,0
10405,"高雄市","六龜區六龜里",1,1,0,3,2,1,1,0
10405,"高雄市","六龜區文武里",3,1,2,2,2,0,4,2
10405,"高雄市","六龜區新發里",0,0,0,1,0,1,1,1
10405,"高雄市","六龜區新寮里",1,0,1,0,0,0,0,0
10405,"高雄市","六龜區新威里",0,0,0,2,1,1,1,0
10405,"高雄市","六龜區新興里",0,0,0,2,1,1,2,1
10405,"高雄市","六龜區興龍里",1,1,0,3,0,3,0,1
10405,"高雄市","六龜區義寶里",0,0,0,5,2,3,1,2
10405,"高雄市","六龜區中興里",1,0,1,4,4,0,4,0
10405,"高雄市","路竹區北嶺里",2,2,0,1,1,0,2,1
10405,"高雄市","路竹區頂寮里",0,0,0,1,1,0,3,0
10405,"高雄市","路竹區後鄉里",1,1,0,3,1,2,0,2
10405,"高雄市","路竹區甲北里",2,1,1,1,0,1,1,0
10405,"高雄市","路竹區甲南里",2,2,0,7,5,2,2,1
10405,"高雄市","路竹區三爺里",1,1,0,2,2,0,1,0
10405,"高雄市","路竹區社東里",1,1,0,3,1,2,2,1
10405,"高雄市","路竹區社南里",4,3,1,4,4,0,12,2
10405,"高雄市","路竹區社西里",6,3,3,8,5,3,5,0
10405,"高雄市","路竹區社中里",2,1,1,0,0,0,0,0
10405,"高雄市","路竹區文北里",8,3,5,6,3,3,3,0
10405,"高雄市","路竹區文南里",8,6,2,6,4,2,4,0
10405,"高雄市","路竹區下坑里",4,1,3,3,1,2,4,0
10405,"高雄市","路竹區新達里",4,0,4,2,1,1,2,0
10405,"高雄市","路竹區鴨寮里",2,2,0,4,4,0,3,0
10405,"高雄市","路竹區竹東里",12,9,3,3,2,1,7,0
10405,"高雄市","路竹區竹滬里",4,2,2,4,1,3,1,3
10405,"高雄市","路竹區竹南里",8,2,6,5,3,2,6,0
10405,"高雄市","路竹區竹西里",3,1,2,1,1,0,2,1
10405,"高雄市","路竹區竹園里",3,1,2,3,2,1,3,0
10405,"高雄市","茂林區多納里",1,0,1,2,2,0,0,0
10405,"高雄市","茂林區茂林里",0,0,0,0,0,0,2,2
10405,"高雄市","茂林區萬山里",1,1,0,0,0,0,1,0
10405,"高雄市","美濃區德興里",4,2,2,2,0,2,2,0
10405,"高雄市","美濃區東門里",0,0,0,3,1,2,0,0
10405,"高雄市","美濃區福安里",2,1,1,5,3,2,2,1
10405,"高雄市","美濃區廣德里",2,1,1,5,2,3,2,0
10405,"高雄市","美濃區廣林里",0,0,0,3,3,0,1,1
10405,"高雄市","美濃區合和里",4,2,2,8,6,2,0,3
10405,"高雄市","美濃區吉東里",1,0,1,3,2,1,2,0
10405,"高雄市","美濃區吉和里",1,0,1,7,5,2,2,1
10405,"高雄市","美濃區吉洋里",3,1,2,6,5,1,4,2
10405,"高雄市","美濃區龍肚里",1,0,1,2,2,0,0,0
10405,"高雄市","美濃區龍山里",2,2,0,5,0,5,4,0
10405,"高雄市","美濃區祿興里",3,2,1,4,2,2,3,1
10405,"高雄市","美濃區瀰濃里",3,1,2,5,2,3,3,2
10405,"高雄市","美濃區清水里",1,0,1,5,3,2,3,0
10405,"高雄市","美濃區獅山里",4,1,3,2,0,2,2,1
10405,"高雄市","美濃區泰安里",0,0,0,4,2,2,3,0
10405,"高雄市","美濃區興隆里",0,0,0,8,5,3,1,0
10405,"高雄市","美濃區中壇里",5,3,2,8,4,4,2,1
10405,"高雄市","美濃區中圳里",2,0,2,2,2,0,1,0
10405,"高雄市","彌陀區光和里",4,2,2,2,2,0,4,1
10405,"高雄市","彌陀區過港里",2,1,1,1,0,1,2,0
10405,"高雄市","彌陀區海尾里",2,1,1,3,3,0,3,2
10405,"高雄市","彌陀區舊港里",7,4,3,0,0,0,2,1
10405,"高雄市","彌陀區漯底里",3,2,1,0,0,0,4,0
10405,"高雄市","彌陀區彌靖里",2,1,1,3,1,2,2,1
10405,"高雄市","彌陀區彌仁里",0,0,0,1,1,0,1,0
10405,"高雄市","彌陀區彌壽里",1,0,1,0,0,0,1,2
10405,"高雄市","彌陀區彌陀里",7,4,3,5,5,0,1,0
10405,"高雄市","彌陀區南寮里",1,0,1,2,1,1,1,2
10405,"高雄市","彌陀區文安里",0,0,0,4,2,2,1,0
10405,"高雄市","彌陀區鹽埕里",3,3,0,6,3,3,2,0
10405,"高雄市","那瑪夏區達卡努瓦里",6,2,4,0,0,0,3,0
10405,"高雄市","那瑪夏區瑪雅里",2,2,0,2,1,1,0,0
10405,"高雄市","那瑪夏區南沙魯里",0,0,0,1,0,1,1,1
10405,"高雄市","楠梓區翠屏里",17,9,8,10,8,2,27,7
10405,"高雄市","楠梓區大昌里",2,1,1,3,2,1,3,2
10405,"高雄市","楠梓區東寧里",7,6,1,2,1,1,8,1
10405,"高雄市","楠梓區福昌里",3,2,1,3,1,2,5,1
10405,"高雄市","楠梓區廣昌里",4,2,2,6,3,3,3,1
10405,"高雄市","楠梓區國昌里",5,3,2,5,5,0,6,3
10405,"高雄市","楠梓區和昌里",2,0,2,3,2,1,1,0
10405,"高雄市","楠梓區宏昌里",5,4,1,4,2,2,6,1
10405,"高雄市","楠梓區宏南里",0,0,0,2,1,1,0,0
10405,"高雄市","楠梓區宏榮里",2,2,0,6,5,1,6,0
10405,"高雄市","楠梓區宏毅里",1,0,1,9,4,5,5,0
10405,"高雄市","楠梓區惠豐里",8,3,5,2,0,2,8,1
10405,"高雄市","楠梓區惠民里",5,3,2,2,1,1,6,2
10405,"高雄市","楠梓區惠楠里",2,0,2,1,1,0,4,1
10405,"高雄市","楠梓區加昌里",16,12,4,14,8,6,18,5
10405,"高雄市","楠梓區建昌里",2,1,1,6,4,2,4,1
10405,"高雄市","楠梓區金田里",7,2,5,4,4,0,4,1
10405,"高雄市","楠梓區錦屏里",7,1,6,8,4,4,6,0
10405,"高雄市","楠梓區久昌里",2,2,0,1,1,0,4,2
10405,"高雄市","楠梓區藍田里",8,3,5,2,1,1,14,2
10405,"高雄市","楠梓區隆昌里",4,0,4,6,3,3,4,0
10405,"高雄市","楠梓區清豐里",47,27,20,19,12,7,34,15
10405,"高雄市","楠梓區慶昌里",3,1,2,6,3,3,4,3
10405,"高雄市","楠梓區仁昌里",12,6,6,4,2,2,5,1
10405,"高雄市","楠梓區稔田里",2,0,2,6,6,0,2,1
10405,"高雄市","楠梓區瑞屏里",7,2,5,4,2,2,9,0
10405,"高雄市","楠梓區盛昌里",7,3,4,7,4,3,8,2
10405,"高雄市","楠梓區泰昌里",2,2,0,2,2,0,3,0
10405,"高雄市","楠梓區五常里",9,3,6,9,6,3,14,1
10405,"高雄市","楠梓區享平里",4,2,2,5,2,3,0,2
10405,"高雄市","楠梓區興昌里",9,8,1,4,2,2,4,2
10405,"高雄市","楠梓區秀昌里",3,2,1,6,6,0,2,0
10405,"高雄市","楠梓區玉屏里",5,3,2,4,1,3,5,3
10405,"高雄市","楠梓區裕昌里",5,3,2,6,2,4,2,3
10405,"高雄市","楠梓區中和里",4,2,2,3,3,0,6,0
10405,"高雄市","楠梓區中興里",5,3,2,3,3,0,3,0
10405,"高雄市","楠梓區中陽里",2,1,1,2,1,1,4,1
10405,"高雄市","內門區東埔里",0,0,0,0,0,0,2,2
10405,"高雄市","內門區溝坪里",0,0,0,2,2,0,0,1
10405,"高雄市","內門區觀亭里",2,2,0,3,2,1,1,0
10405,"高雄市","內門區光興里",0,0,0,1,0,1,0,0
10405,"高雄市","內門區金竹里",0,0,0,5,3,2,1,0
10405,"高雄市","內門區木柵里",1,0,1,2,0,2,1,0
10405,"高雄市","內門區內東里",0,0,0,1,1,0,1,0
10405,"高雄市","內門區內豊里",2,1,1,2,2,0,3,2
10405,"高雄市","內門區內門里",2,0,2,3,2,1,0,2
10405,"高雄市","內門區內南里",0,0,0,0,0,0,1,0
10405,"高雄市","內門區內興里",0,0,0,2,2,0,0,0
10405,"高雄市","內門區瑞山里",0,0,0,1,1,0,0,0
10405,"高雄市","內門區三平里",0,0,0,1,0,1,2,0
10405,"高雄市","內門區石坑里",1,1,0,2,2,0,1,0
10405,"高雄市","內門區永富里",2,0,2,2,0,2,1,0
10405,"高雄市","內門區永吉里",0,0,0,2,1,1,1,1
10405,"高雄市","內門區永興里",0,0,0,1,1,0,0,0
10405,"高雄市","內門區中埔里",0,0,0,1,0,1,0,0
10405,"高雄市","鳥松區大華里",11,7,4,12,10,2,14,2
10405,"高雄市","鳥松區大竹里",0,0,0,1,0,1,4,0
10405,"高雄市","鳥松區坔埔里",6,4,2,6,4,2,5,0
10405,"高雄市","鳥松區華美里",7,4,3,3,2,1,4,0
10405,"高雄市","鳥松區夢裡里",6,3,3,5,2,3,9,3
10405,"高雄市","鳥松區鳥松里",17,9,8,12,7,5,12,0
10405,"高雄市","鳥松區仁美里",9,3,6,9,7,2,10,0
10405,"高雄市","旗津區安順里",2,1,1,3,1,2,1,1
10405,"高雄市","旗津區北汕里",4,2,2,4,4,0,3,2
10405,"高雄市","旗津區慈愛里",2,1,1,6,5,1,3,1
10405,"高雄市","旗津區復興里",8,5,3,10,4,6,2,0
10405,"高雄市","旗津區南汕里",4,2,2,3,3,0,4,0
10405,"高雄市","旗津區旗下里",1,1,0,4,4,0,1,1
10405,"高雄市","旗津區上竹里",6,2,4,5,0,5,4,0
10405,"高雄市","旗津區實踐里",3,2,1,4,3,1,1,1
10405,"高雄市","旗津區永安里",2,0,2,3,3,0,3,1
10405,"高雄市","旗津區振興里",3,0,3,7,6,1,3,0
10405,"高雄市","旗津區中華里",4,2,2,0,0,0,3,1
10405,"高雄市","旗津區中興里",4,1,3,4,4,0,7,3
10405,"高雄市","旗津區中洲里",2,2,0,2,1,1,2,1
10405,"高雄市","旗山區大德里",4,2,2,2,0,2,5,2
10405,"高雄市","旗山區大林里",1,1,0,5,3,2,2,3
10405,"高雄市","旗山區大山里",2,0,2,3,1,2,2,0
10405,"高雄市","旗山區東昌里",1,0,1,0,0,0,0,1
10405,"高雄市","旗山區東平里",0,0,0,1,1,0,5,0
10405,"高雄市","旗山區廣福里",0,0,0,1,1,0,1,0
10405,"高雄市","旗山區鯤洲里",1,0,1,1,0,1,2,0
10405,"高雄市","旗山區湄洲里",1,0,1,1,1,0,3,2
10405,"高雄市","旗山區南勝里",1,1,0,5,2,3,3,1
10405,"高雄市","旗山區南洲里",1,1,0,1,0,1,1,1
10405,"高雄市","旗山區瑞吉里",1,0,1,6,5,1,2,1
10405,"高雄市","旗山區三協里",3,1,2,4,3,1,5,1
10405,"高雄市","旗山區上洲里",0,0,0,3,1,2,1,0
10405,"高雄市","旗山區太平里",2,1,1,3,1,2,3,1
10405,"高雄市","旗山區新光里",0,0,0,2,0,2,0,0
10405,"高雄市","旗山區永和里",4,2,2,7,3,4,4,2
10405,"高雄市","旗山區圓富里",5,2,3,8,8,0,2,2
10405,"高雄市","旗山區中寮里",0,0,0,0,0,0,0,0
10405,"高雄市","旗山區中正里",3,2,1,1,0,1,1,0
10405,"高雄市","旗山區中洲里",1,1,0,1,1,0,2,0
10405,"高雄市","旗山區竹峰里",1,0,1,4,3,1,2,1
10405,"高雄市","前金區北金里",1,0,1,3,1,2,2,2
10405,"高雄市","前金區博孝里",1,0,1,3,3,0,2,1
10405,"高雄市","前金區草江里",2,2,0,2,1,1,0,0
10405,"高雄市","前金區東金里",2,0,2,3,3,0,3,0
10405,"高雄市","前金區復元里",1,1,0,0,0,0,1,0
10405,"高雄市","前金區國民里",1,1,0,1,1,0,0,0
10405,"高雄市","前金區後金里",0,0,0,1,0,1,2,0
10405,"高雄市","前金區林投里",3,2,1,2,0,2,0,0
10405,"高雄市","前金區民生里",1,0,1,1,1,0,1,0
10405,"高雄市","前金區青山里",0,0,0,4,3,1,3,0
10405,"高雄市","前金區榮復里",3,3,0,1,1,0,3,0
10405,"高雄市","前金區三川里",0,0,0,4,4,0,0,0
10405,"高雄市","前金區社東里",2,0,2,1,1,0,3,0
10405,"高雄市","前金區社西里",0,0,0,2,1,1,1,0
10405,"高雄市","前金區文東里",1,0,1,2,2,0,0,1
10405,"高雄市","前金區文西里",2,1,1,3,2,1,2,1
10405,"高雄市","前金區新生里",4,1,3,2,1,1,5,3
10405,"高雄市","前金區長城里",1,1,0,2,1,1,2,1
10405,"高雄市","前金區長生里",1,1,0,4,3,1,1,0
10405,"高雄市","前金區長興里",1,0,1,2,0,2,4,1
10405,"高雄市","前鎮區草衙里",15,10,5,10,9,1,15,7
10405,"高雄市","前鎮區德昌里",2,1,1,7,5,2,0,1
10405,"高雄市","前鎮區復國里",4,2,2,4,2,2,5,2
10405,"高雄市","前鎮區建隆里",3,0,3,3,3,0,2,0
10405,"高雄市","前鎮區良和里",6,3,3,4,4,0,4,1
10405,"高雄市","前鎮區民權里",6,4,2,6,4,2,5,1
10405,"高雄市","前鎮區明道里",2,1,1,4,2,2,1,0
10405,"高雄市","前鎮區明禮里",1,1,0,4,3,1,1,1
10405,"高雄市","前鎮區明孝里",1,0,1,8,7,1,1,1
10405,"高雄市","前鎮區明義里",5,1,4,4,0,4,2,0
10405,"高雄市","前鎮區明正里",10,1,9,5,4,1,8,5
10405,"高雄市","前鎮區平昌里",0,0,0,0,0,0,2,1
10405,"高雄市","前鎮區平等里",3,2,1,6,5,1,4,3
10405,"高雄市","前鎮區前鎮里",2,2,0,1,0,1,0,0
10405,"高雄市","前鎮區仁愛里",3,0,3,3,0,3,1,1
10405,"高雄市","前鎮區瑞北里",2,1,1,3,2,1,3,0
10405,"高雄市","前鎮區瑞昌里",12,7,5,6,4,2,4,0
10405,"高雄市","前鎮區瑞誠里",2,2,0,6,5,1,4,3
10405,"高雄市","前鎮區瑞東里",3,1,2,1,1,0,3,2
10405,"高雄市","前鎮區瑞豐里",2,1,1,3,2,1,5,0
10405,"高雄市","前鎮區瑞崗里",4,1,3,4,4,0,2,0
10405,"高雄市","前鎮區瑞和里",4,2,2,0,0,0,1,1
10405,"高雄市","前鎮區瑞華里",4,4,0,6,2,4,7,1
10405,"高雄市","前鎮區瑞隆里",3,2,1,5,2,3,2,2
10405,"高雄市","前鎮區瑞南里",8,6,2,4,3,1,3,3
10405,"高雄市","前鎮區瑞平里",3,2,1,7,2,5,6,1
10405,"高雄市","前鎮區瑞文里",2,0,2,3,3,0,4,1
10405,"高雄市","前鎮區瑞西里",8,6,2,3,2,1,5,0
10405,"高雄市","前鎮區瑞祥里",6,4,2,5,4,1,10,1
10405,"高雄市","前鎮區瑞興里",6,4,2,8,5,3,4,1
10405,"高雄市","前鎮區瑞竹里",1,1,0,2,2,0,1,2
10405,"高雄市","前鎮區盛豐里",4,3,1,7,5,2,3,1
10405,"高雄市","前鎮區盛興里",3,3,0,4,4,0,6,0
10405,"高雄市","前鎮區西甲里",4,3,1,2,1,1,1,0
10405,"高雄市","前鎮區西山里",3,2,1,8,7,1,5,0
10405,"高雄市","前鎮區信德里",1,1,0,3,1,2,1,2
10405,"高雄市","前鎮區信義里",0,0,0,2,1,1,0,2
10405,"高雄市","前鎮區興邦里",6,5,1,1,1,0,4,2
10405,"高雄市","前鎮區興東里",2,1,1,6,4,2,8,1
10405,"高雄市","前鎮區興化里",1,1,0,2,1,1,0,0
10405,"高雄市","前鎮區興仁里",0,0,0,1,0,1,1,1
10405,"高雄市","前鎮區興中里",3,2,1,6,5,1,5,0
10405,"高雄市","前鎮區振興里",2,1,1,3,3,0,2,1
10405,"高雄市","前鎮區鎮北里",1,0,1,2,0,2,2,0
10405,"高雄市","前鎮區鎮昌里",4,3,1,1,0,1,1,1
10405,"高雄市","前鎮區鎮東里",1,0,1,3,3,0,2,0
10405,"高雄市","前鎮區鎮海里",6,3,3,4,3,1,4,4
10405,"高雄市","前鎮區鎮榮里",2,0,2,2,1,1,5,0
10405,"高雄市","前鎮區鎮陽里",0,0,0,2,1,1,1,0
10405,"高雄市","前鎮區鎮中里",0,0,0,3,2,1,0,0
10405,"高雄市","前鎮區忠誠里",5,3,2,6,6,0,6,1
10405,"高雄市","前鎮區忠純里",6,3,3,10,3,7,8,3
10405,"高雄市","前鎮區忠孝里",1,0,1,8,3,5,2,1
10405,"高雄市","前鎮區竹北里",2,1,1,4,3,1,0,3
10405,"高雄市","前鎮區竹東里",5,4,1,5,4,1,5,0
10405,"高雄市","前鎮區竹南里",14,5,9,12,8,4,12,5
10405,"高雄市","前鎮區竹內里",2,1,1,2,1,1,1,1
10405,"高雄市","前鎮區竹西里",6,3,3,2,2,0,3,0
10405,"高雄市","前鎮區竹中里",3,1,2,4,2,2,5,2
10405,"高雄市","橋頭區白樹里",7,4,3,4,3,1,3,2
10405,"高雄市","橋頭區筆秀里",3,3,0,4,3,1,2,1
10405,"高雄市","橋頭區德松里",0,0,0,0,0,0,3,1
10405,"高雄市","橋頭區頂鹽里",2,0,2,4,1,3,2,1
10405,"高雄市","橋頭區東林里",3,2,1,3,2,1,5,2
10405,"高雄市","橋頭區甲北里",3,3,0,2,2,0,3,3
10405,"高雄市","橋頭區甲南里",4,1,3,2,2,0,3,1
10405,"高雄市","橋頭區橋南里",3,0,3,5,1,4,1,1
10405,"高雄市","橋頭區橋頭里",1,1,0,2,1,1,1,1
10405,"高雄市","橋頭區三德里",0,0,0,5,4,1,2,2
10405,"高雄市","橋頭區仕豐里",5,4,1,1,0,1,2,0
10405,"高雄市","橋頭區仕和里",11,3,8,2,2,0,12,1
10405,"高雄市","橋頭區仕隆里",2,1,1,6,1,5,1,0
10405,"高雄市","橋頭區西林里",1,1,0,3,1,2,2,0
10405,"高雄市","橋頭區新莊里",2,0,2,3,2,1,3,0
10405,"高雄市","橋頭區芋寮里",2,2,0,5,3,2,3,0
10405,"高雄市","橋頭區中崎里",0,0,0,1,0,1,1,1
10405,"高雄市","仁武區八卦里",33,16,17,9,7,2,24,6
10405,"高雄市","仁武區赤山里",9,3,6,2,0,2,7,5
10405,"高雄市","仁武區大灣里",14,8,6,2,0,2,6,1
10405,"高雄市","仁武區高楠里",4,1,3,3,3,0,2,0
10405,"高雄市","仁武區後安里",2,1,1,1,1,0,4,1
10405,"高雄市","仁武區考潭里",4,3,1,2,2,0,4,0
10405,"高雄市","仁武區仁慈里",6,1,5,3,1,2,6,0
10405,"高雄市","仁武區仁福里",0,0,0,0,0,0,2,0
10405,"高雄市","仁武區仁和里",10,5,5,0,0,0,8,3
10405,"高雄市","仁武區仁武里",8,3,5,9,2,7,8,7
10405,"高雄市","仁武區灣內里",11,5,6,3,2,1,13,3
10405,"高雄市","仁武區文武里",15,8,7,8,8,0,6,4
10405,"高雄市","仁武區烏林里",6,5,1,6,3,3,5,3
10405,"高雄市","仁武區五和里",10,7,3,5,4,1,9,2
10405,"高雄市","仁武區中華里",1,1,0,1,1,0,5,2
10405,"高雄市","仁武區竹後里",2,1,1,2,1,1,4,0
10405,"高雄市","三民區安邦里",5,2,3,6,3,3,3,1
10405,"高雄市","三民區安東里",1,0,1,6,2,4,2,1
10405,"高雄市","三民區安發里",6,2,4,7,4,3,5,2
10405,"高雄市","三民區安和里",2,2,0,4,4,0,5,0
10405,"高雄市","三民區安吉里",10,3,7,3,3,0,5,1
10405,"高雄市","三民區安康里",4,1,3,8,1,7,1,2
10405,"高雄市","三民區安寧里",1,0,1,7,7,0,3,1
10405,"高雄市","三民區安生里",2,1,1,3,2,1,0,1
10405,"高雄市","三民區安泰里",7,5,2,4,0,4,8,2
10405,"高雄市","三民區安宜里",4,0,4,3,3,0,5,3
10405,"高雄市","三民區寶安里",8,5,3,6,3,3,10,3
10405,"高雄市","三民區寶德里",10,3,7,1,1,0,8,2
10405,"高雄市","三民區寶國里",8,1,7,9,8,1,12,5
10405,"高雄市","三民區寶華里",5,4,1,3,2,1,6,2
10405,"高雄市","三民區寶龍里",4,3,1,4,3,1,9,3
10405,"高雄市","三民區寶民里",7,4,3,4,2,2,7,2
10405,"高雄市","三民區寶慶里",4,1,3,2,2,0,4,0
10405,"高雄市","三民區寶盛里",3,2,1,4,3,1,7,2
10405,"高雄市","三民區寶獅里",4,0,4,2,2,0,3,2
10405,"高雄市","三民區寶泰里",5,4,1,4,1,3,8,1
10405,"高雄市","三民區寶興里",16,8,8,4,1,3,9,2
10405,"高雄市","三民區寶業里",12,6,6,2,1,1,8,0
10405,"高雄市","三民區寶玉里",9,7,2,6,4,2,10,3
10405,"高雄市","三民區寶中里",8,7,1,4,4,0,4,1
10405,"高雄市","三民區寶珠里",8,5,3,3,2,1,10,1
10405,"高雄市","三民區本安里",5,3,2,2,1,1,7,2
10405,"高雄市","三民區本館里",26,13,13,12,7,5,13,4
10405,"高雄市","三民區本和里",11,4,7,4,1,3,11,4
10405,"高雄市","三民區本上里",8,3,5,4,3,1,8,1
10405,"高雄市","三民區本文里",0,0,0,1,1,0,3,2
10405,"高雄市","三民區本武里",2,1,1,2,1,1,1,0
10405,"高雄市","三民區本揚里",12,7,5,11,2,9,9,3
10405,"高雄市","三民區本元里",10,1,9,4,3,1,11,2
10405,"高雄市","三民區博愛里",4,1,3,2,0,2,0,0
10405,"高雄市","三民區博惠里",4,4,0,4,2,2,5,2
10405,"高雄市","三民區川東里",2,1,1,1,0,1,3,0
10405,"高雄市","三民區達德里",1,0,1,1,1,0,2,0
10405,"高雄市","三民區達明里",4,4,0,1,1,0,1,0
10405,"高雄市","三民區達仁里",4,2,2,3,1,2,0,0
10405,"高雄市","三民區達勇里",1,1,0,3,1,2,0,1
10405,"高雄市","三民區德北里",0,0,0,1,1,0,3,0
10405,"高雄市","三民區德東里",0,0,0,1,0,1,1,0
10405,"高雄市","三民區德仁里",2,1,1,6,4,2,2,1
10405,"高雄市","三民區德西里",0,0,0,2,2,0,2,0
10405,"高雄市","三民區德行里",4,1,3,2,1,1,1,0
10405,"高雄市","三民區德智里",7,3,4,5,1,4,2,0
10405,"高雄市","三民區鼎金里",8,4,4,7,2,5,5,0
10405,"高雄市","三民區鼎力里",4,1,3,5,3,2,6,3
10405,"高雄市","三民區鼎強里",5,2,3,1,0,1,7,2
10405,"高雄市","三民區鼎盛里",16,12,4,7,5,2,7,5
10405,"高雄市","三民區鼎泰里",32,13,19,13,5,8,32,5
10405,"高雄市","三民區鼎西里",17,10,7,6,4,2,13,5
10405,"高雄市","三民區鼎中里",3,1,2,6,2,4,5,0
10405,"高雄市","三民區豐裕里",1,1,0,5,4,1,2,1
10405,"高雄市","三民區鳳北里",4,1,3,3,2,1,4,0
10405,"高雄市","三民區鳳南里",1,1,0,2,1,1,0,0
10405,"高雄市","三民區港東里",2,1,1,1,1,0,2,1
10405,"高雄市","三民區港西里",1,1,0,2,1,1,1,1
10405,"高雄市","三民區港新里",1,0,1,2,1,1,4,1
10405,"高雄市","三民區建東里",1,1,0,2,0,2,3,0
10405,"高雄市","三民區精華里",0,0,0,1,0,1,2,0
10405,"高雄市","三民區力行里",2,1,1,5,4,1,2,0
10405,"高雄市","三民區立誠里",1,1,0,1,1,0,0,0
10405,"高雄市","三民區立德里",0,0,0,2,0,2,0,0
10405,"高雄市","三民區立業里",0,0,0,3,2,1,0,0
10405,"高雄市","三民區民享里",3,2,1,3,2,1,4,0
10405,"高雄市","三民區千北里",2,2,0,3,3,0,0,0
10405,"高雄市","三民區千秋里",4,2,2,3,2,1,1,1
10405,"高雄市","三民區千歲里",1,1,0,2,1,1,1,1
10405,"高雄市","三民區十美里",1,0,1,3,2,1,4,0
10405,"高雄市","三民區十全里",2,2,0,4,2,2,2,1
10405,"高雄市","三民區同德里",0,0,0,4,2,2,6,3
10405,"高雄市","三民區灣愛里",3,0,3,4,3,1,2,2
10405,"高雄市","三民區灣成里",4,1,3,5,3,2,6,1
10405,"高雄市","三民區灣復里",2,0,2,3,2,1,5,2
10405,"高雄市","三民區灣華里",4,3,1,8,5,3,5,0
10405,"高雄市","三民區灣利里",3,1,2,8,4,4,8,1
10405,"高雄市","三民區灣勝里",2,1,1,3,2,1,3,2
10405,"高雄市","三民區灣興里",2,2,0,5,2,3,2,1
10405,"高雄市","三民區灣中里",7,6,1,4,2,2,8,6
10405,"高雄市","三民區灣子里",5,1,4,7,2,5,6,4
10405,"高雄市","三民區興德里",2,2,0,4,2,2,5,4
10405,"高雄市","三民區裕民里",1,0,1,4,3,1,1,2
10405,"高雄市","三民區長明里",3,1,2,3,1,2,0,0
10405,"高雄市","三民區正順里",9,2,7,4,2,2,6,1
10405,"高雄市","三民區正興里",20,15,5,10,7,3,15,2
10405,"高雄市","杉林區大愛里",5,2,3,3,2,1,0,1
10405,"高雄市","杉林區集來里",0,0,0,4,2,2,0,0
10405,"高雄市","杉林區木梓里",0,0,0,2,0,2,1,1
10405,"高雄市","杉林區杉林里",0,0,0,2,1,1,0,0
10405,"高雄市","杉林區上平里",1,1,0,5,4,1,2,3
10405,"高雄市","杉林區新庄里",0,0,0,3,3,0,0,0
10405,"高雄市","杉林區月眉里",1,1,0,3,3,0,3,1
10405,"高雄市","杉林區月美里",0,0,0,4,1,3,0,2
10405,"高雄市","桃源區寶山里",1,1,0,1,1,0,0,0
10405,"高雄市","桃源區復興里",0,0,0,0,0,0,0,1
10405,"高雄市","桃源區高中里",1,1,0,3,3,0,2,0
10405,"高雄市","桃源區建山里",0,0,0,2,2,0,2,0
10405,"高雄市","桃源區拉芙蘭里",0,0,0,0,0,0,0,1
10405,"高雄市","桃源區梅山里",1,1,0,0,0,0,1,0
10405,"高雄市","桃源區勤和里",0,0,0,0,0,0,0,0
10405,"高雄市","桃源區桃源里",1,1,0,2,2,0,3,0
10405,"高雄市","田寮區崇德里",2,2,0,2,1,1,2,0
10405,"高雄市","田寮區大同里",0,0,0,0,0,0,0,0
10405,"高雄市","田寮區古亭里",0,0,0,2,1,1,1,1
10405,"高雄市","田寮區鹿埔里",0,0,0,0,0,0,0,0
10405,"高雄市","田寮區南安里",0,0,0,6,2,4,0,0
10405,"高雄市","田寮區七星里",0,0,0,1,1,0,1,0
10405,"高雄市","田寮區三和里",0,0,0,2,0,2,0,0
10405,"高雄市","田寮區田寮里",0,0,0,0,0,0,1,0
10405,"高雄市","田寮區西德里",0,0,0,1,0,1,1,1
10405,"高雄市","田寮區新興里",0,0,0,1,1,0,0,1
10405,"高雄市","小港區大苓里",2,0,2,3,2,1,2,0
10405,"高雄市","小港區大坪里",4,1,3,4,2,2,5,0
10405,"高雄市","小港區店鎮里",8,4,4,5,3,2,10,5
10405,"高雄市","小港區二苓里",3,1,2,1,1,0,6,1
10405,"高雄市","小港區鳳宮里",2,0,2,3,1,2,1,2
10405,"高雄市","小港區鳳林里",10,4,6,1,1,0,5,1
10405,"高雄市","小港區鳳鳴里",3,1,2,6,4,2,5,4
10405,"高雄市","小港區鳳森里",4,3,1,1,1,0,0,1
10405,"高雄市","小港區鳳興里",3,3,0,3,1,2,2,1
10405,"高雄市","小港區鳳源里",4,1,3,7,6,1,6,2
10405,"高雄市","小港區港后里",5,2,3,5,4,1,7,2
10405,"高雄市","小港區港口里",5,1,4,5,2,3,7,3
10405,"高雄市","小港區港明里",3,3,0,2,0,2,5,1
10405,"高雄市","小港區港南里",2,1,1,2,2,0,2,1
10405,"高雄市","小港區港墘里",5,1,4,3,3,0,0,0
10405,"高雄市","小港區港興里",3,1,2,2,2,0,3,1
10405,"高雄市","小港區港正里",3,0,3,1,0,1,3,1
10405,"高雄市","小港區高松里",7,4,3,3,3,0,8,3
10405,"高雄市","小港區桂林里",13,11,2,5,4,1,11,5
10405,"高雄市","小港區合作里",5,0,5,1,1,0,4,0
10405,"高雄市","小港區宏亮里",3,1,2,5,4,1,1,1
10405,"高雄市","小港區濟南里",4,1,3,2,0,2,9,0
10405,"高雄市","小港區孔宅里",7,4,3,3,2,1,9,1
10405,"高雄市","小港區六苓里",2,1,1,5,3,2,6,1
10405,"高雄市","小港區龍鳳里",1,0,1,3,3,0,6,2
10405,"高雄市","小港區坪頂里",11,5,6,9,6,3,9,2
10405,"高雄市","小港區青島里",4,3,1,4,3,1,3,2
10405,"高雄市","小港區三苓里",4,2,2,3,1,2,2,2
10405,"高雄市","小港區廈莊里",3,2,1,3,3,0,6,2
10405,"高雄市","小港區山東里",4,1,3,3,3,0,3,3
10405,"高雄市","小港區山明里",20,14,6,7,2,5,25,7
10405,"高雄市","小港區順苓里",13,6,7,10,6,4,6,1
10405,"高雄市","小港區松金里",5,2,3,2,2,0,1,0
10405,"高雄市","小港區松山里",3,2,1,7,5,2,1,1
10405,"高雄市","小港區泰山里",6,3,3,2,1,1,7,0
10405,"高雄市","小港區小港里",1,0,1,2,1,1,2,1
10405,"高雄市","小港區正苓里",4,3,1,3,1,2,8,4
10405,"高雄市","小港區中厝里",3,1,2,5,1,4,2,0
10405,"高雄市","新興區愛平里",0,0,0,1,0,1,0,1
10405,"高雄市","新興區成功里",1,1,0,1,0,1,3,0
10405,"高雄市","新興區大明里",0,0,0,4,2,2,0,0
10405,"高雄市","新興區德生里",4,1,3,3,2,1,2,2
10405,"高雄市","新興區德望里",0,0,0,5,2,3,2,0
10405,"高雄市","新興區德政里",0,0,0,2,1,1,0,0
10405,"高雄市","新興區東坡里",1,0,1,1,0,1,4,0
10405,"高雄市","新興區光耀里",4,2,2,4,3,1,2,2
10405,"高雄市","新興區漢民里",0,0,0,1,0,1,2,0
10405,"高雄市","新興區浩然里",0,0,0,5,1,4,4,1
10405,"高雄市","新興區華聲里",2,2,0,1,0,1,2,1
10405,"高雄市","新興區建華里",1,1,0,2,2,0,2,0
10405,"高雄市","新興區建興里",2,0,2,1,1,0,0,2
10405,"高雄市","新興區蕉園里",0,0,0,1,0,1,1,0
10405,"高雄市","新興區開平里",3,2,1,4,1,3,2,0
10405,"高雄市","新興區黎明里",0,0,0,3,3,0,1,0
10405,"高雄市","新興區明莊里",1,0,1,0,0,0,2,0
10405,"高雄市","新興區南港里",4,3,1,1,0,1,2,0
10405,"高雄市","新興區秋山里",1,0,1,6,4,2,0,1
10405,"高雄市","新興區仁聲里",0,0,0,2,2,0,2,1
10405,"高雄市","新興區榮治里",1,1,0,1,0,1,1,0
10405,"高雄市","新興區順昌里",5,2,3,6,2,4,1,1
10405,"高雄市","新興區文昌里",4,3,1,3,0,3,2,0
10405,"高雄市","新興區新江里",1,1,0,3,3,0,0,1
10405,"高雄市","新興區興昌里",3,1,2,1,0,1,1,0
10405,"高雄市","新興區永寧里",0,0,0,1,0,1,3,2
10405,"高雄市","新興區玉衡里",0,0,0,0,0,0,2,0
10405,"高雄市","新興區長驛里",2,1,1,1,1,0,0,0
10405,"高雄市","新興區振成里",0,0,0,1,0,1,3,1
10405,"高雄市","新興區振華里",1,0,1,1,0,1,2,2
10405,"高雄市","新興區正氣里",1,1,0,2,0,2,0,1
10405,"高雄市","新興區中東里",2,2,0,4,2,2,3,1
10405,"高雄市","鹽埕區博愛里",2,0,2,2,2,0,0,0
10405,"高雄市","鹽埕區慈愛里",0,0,0,1,1,0,0,0
10405,"高雄市","鹽埕區府北里",3,1,2,3,0,3,4,2
10405,"高雄市","鹽埕區港都里",1,0,1,2,1,1,2,0
10405,"高雄市","鹽埕區光明里",1,0,1,5,3,2,0,0
10405,"高雄市","鹽埕區河濱里",5,4,1,3,1,2,3,0
10405,"高雄市","鹽埕區江南里",1,1,0,3,0,3,0,1
10405,"高雄市","鹽埕區江西里",0,0,0,2,1,1,0,0
10405,"高雄市","鹽埕區教仁里",1,1,0,3,0,3,1,4
10405,"高雄市","鹽埕區瀨南里",0,0,0,1,1,0,1,1
10405,"高雄市","鹽埕區藍橋里",1,1,0,1,0,1,0,0
10405,"高雄市","鹽埕區陸橋里",1,1,0,3,1,2,2,0
10405,"高雄市","鹽埕區南端里",0,0,0,0,0,0,2,1
10405,"高雄市","鹽埕區沙地里",0,0,0,1,0,1,1,0
10405,"高雄市","鹽埕區壽星里",2,2,0,4,2,2,2,1
10405,"高雄市","鹽埕區新豐里",1,1,0,0,0,0,1,0
10405,"高雄市","鹽埕區新化里",1,1,0,2,0,2,0,0
10405,"高雄市","鹽埕區新樂里",2,2,0,1,1,0,0,0
10405,"高雄市","鹽埕區育仁里",0,0,0,2,2,0,0,1
10405,"高雄市","鹽埕區中山里",1,0,1,0,0,0,0,1
10405,"高雄市","鹽埕區中原里",0,0,0,0,0,0,0,0
10405,"高雄市","燕巢區安招里",4,1,3,12,10,2,3,0
10405,"高雄市","燕巢區東燕里",4,2,2,8,5,3,4,3
10405,"高雄市","燕巢區鳳雄里",3,1,2,4,2,2,4,2
10405,"高雄市","燕巢區橫山里",2,1,1,9,8,1,4,0
10405,"高雄市","燕巢區尖山里",1,1,0,3,2,1,1,1
10405,"高雄市","燕巢區角宿里",5,2,3,4,2,2,4,1
10405,"高雄市","燕巢區金山里",1,0,1,1,0,1,0,0
10405,"高雄市","燕巢區南燕里",7,4,3,1,1,0,4,2
10405,"高雄市","燕巢區瓊林里",6,2,4,3,1,2,3,2
10405,"高雄市","燕巢區深水里",6,5,1,4,3,1,1,1
10405,"高雄市","燕巢區西燕里",5,2,3,3,1,2,3,2
10405,"高雄市","永安區保寧里",6,4,2,2,0,2,3,0
10405,"高雄市","永安區維新里",7,3,4,6,4,2,5,1
10405,"高雄市","永安區新港里",3,0,3,2,2,0,2,1
10405,"高雄市","永安區鹽田里",1,1,0,0,0,0,1,0
10405,"高雄市","永安區永安里",3,2,1,5,5,0,1,0
10405,"高雄市","永安區永華里",5,2,3,2,1,1,1,2
10405,"高雄市","梓官區赤東里",5,4,1,4,3,1,2,1
10405,"高雄市","梓官區赤崁里",9,4,5,7,4,3,3,0
10405,"高雄市","梓官區赤西里",3,2,1,0,0,0,3,0
10405,"高雄市","梓官區大舍里",6,3,3,5,2,3,4,0
10405,"高雄市","梓官區典寶里",4,2,2,5,5,0,1,0
10405,"高雄市","梓官區茄苳里",3,2,1,4,3,1,2,0
10405,"高雄市","梓官區禮蚵里",3,2,1,6,2,4,4,0
10405,"高雄市","梓官區同安里",2,2,0,1,1,0,2,0
10405,"高雄市","梓官區信蚵里",7,4,3,1,1,0,1,1
10405,"高雄市","梓官區智蚵里",7,5,2,1,1,0,3,2
10405,"高雄市","梓官區中崙里",0,0,0,1,0,1,1,0
10405,"高雄市","梓官區梓和里",3,2,1,1,1,0,3,0
10405,"高雄市","梓官區梓平里",2,1,1,1,1,0,0,0
10405,"高雄市","梓官區梓信里",7,3,4,3,1,2,5,1
10405,"高雄市","梓官區梓義里",2,0,2,5,2,3,2,0
10405,"高雄市","左營區菜公里",47,31,16,24,14,10,37,16
10405,"高雄市","左營區城南里",0,0,0,1,1,0,0,0
10405,"高雄市","左營區崇實里",9,5,4,4,3,1,6,1
10405,"高雄市","左營區頂北里",0,0,0,2,2,0,1,0
10405,"高雄市","左營區頂西里",0,0,0,5,3,2,4,1
10405,"高雄市","左營區福山里",62,31,31,26,15,11,53,17
10405,"高雄市","左營區光輝里",1,1,0,4,3,1,2,0
10405,"高雄市","左營區果峰里",2,0,2,3,2,1,2,2
10405,"高雄市","左營區果惠里",1,1,0,6,6,0,2,3
10405,"高雄市","左營區果貿里",1,0,1,5,5,0,4,1
10405,"高雄市","左營區海勝里",5,2,3,17,14,3,8,7
10405,"高雄市","左營區合群里",2,0,2,5,4,1,2,1
10405,"高雄市","左營區進學里",0,0,0,6,6,0,0,2
10405,"高雄市","左營區莒光里",1,1,0,7,5,2,4,1
10405,"高雄市","左營區路東里",0,0,0,3,1,2,1,0
10405,"高雄市","左營區廟北里",0,0,0,3,2,1,0,0
10405,"高雄市","左營區廟東里",1,1,0,1,0,1,0,1
10405,"高雄市","左營區明建里",1,1,0,5,1,4,1,0
10405,"高雄市","左營區埤北里",0,0,0,7,3,4,1,1
10405,"高雄市","左營區埤東里",0,0,0,2,1,1,1,2
10405,"高雄市","左營區埤西里",0,0,0,3,1,2,0,0
10405,"高雄市","左營區屏山里",1,0,1,6,4,2,2,3
10405,"高雄市","左營區廍北里",1,1,0,1,1,0,0,0
10405,"高雄市","左營區廍南里",0,0,0,0,0,0,0,0
10405,"高雄市","左營區聖后里",3,2,1,5,0,5,1,0
10405,"高雄市","左營區聖南里",2,2,0,3,3,0,2,0
10405,"高雄市","左營區聖西里",2,2,0,3,2,1,1,1
10405,"高雄市","左營區尾北里",4,1,3,6,4,2,2,3
10405,"高雄市","左營區尾南里",0,0,0,0,0,0,0,1
10405,"高雄市","左營區尾西里",1,1,0,3,2,1,2,0
10405,"高雄市","左營區祥和里",0,0,0,1,1,0,2,0
10405,"高雄市","左營區新光里",34,20,14,5,2,3,10,9
10405,"高雄市","左營區新上里",32,18,14,15,11,4,40,8
10405,"高雄市","左營區新下里",21,11,10,9,5,4,12,8
10405,"高雄市","左營區新中里",6,2,4,7,5,2,7,1
10405,"高雄市","左營區永清里",8,2,6,2,2,0,0,0
10405,"高雄市","左營區中北里",2,1,1,3,1,2,0,0
10405,"高雄市","左營區中南里",2,2,0,1,1,0,1,0
10405,"高雄市","左營區自助里",2,0,2,2,0,2,1,0
10407,"高雄市","阿蓮區阿蓮里",16,6,10,7,4,3,5,2
10407,"高雄市","阿蓮區峯山里",0,0,0,1,1,0,0,1
10407,"高雄市","阿蓮區復安里",3,2,1,3,1,2,1,1
10407,"高雄市","阿蓮區崗山里",1,0,1,1,0,1,0,0
10407,"高雄市","阿蓮區港後里",1,1,0,2,2,0,2,1
10407,"高雄市","阿蓮區和蓮里",2,1,1,3,2,1,1,3
10407,"高雄市","阿蓮區南蓮里",0,0,0,10,8,2,1,1
10407,"高雄市","阿蓮區青旗里",0,0,0,3,3,0,0,0
10407,"高雄市","阿蓮區清蓮里",3,2,1,2,1,1,4,2
10407,"高雄市","阿蓮區石安里",1,1,0,2,1,1,1,0
10407,"高雄市","阿蓮區玉庫里",2,1,1,1,1,0,0,0
10407,"高雄市","阿蓮區中路里",3,1,2,3,2,1,0,1
10407,"高雄市","大寮區潮寮里",4,3,1,3,1,2,1,1
10407,"高雄市","大寮區大寮里",13,4,9,10,5,5,6,5
10407,"高雄市","大寮區光武里",0,0,0,3,1,2,0,0
10407,"高雄市","大寮區過溪里",9,4,5,3,2,1,4,3
10407,"高雄市","大寮區後庄里",17,9,8,7,2,5,4,9
10407,"高雄市","大寮區會結里",2,1,1,2,1,1,0,0
10407,"高雄市","大寮區會社里",11,7,4,9,7,2,3,4
10407,"高雄市","大寮區江山里",5,3,2,8,8,0,1,2
10407,"高雄市","大寮區拷潭里",1,1,0,4,4,0,2,1
10407,"高雄市","大寮區琉球里",4,3,1,6,3,3,3,1
10407,"高雄市","大寮區內坑里",11,6,5,8,6,2,6,3
10407,"高雄市","大寮區前庄里",1,1,0,2,2,0,2,1
10407,"高雄市","大寮區三隆里",8,5,3,10,6,4,8,1
10407,"高雄市","大寮區山頂里",15,7,8,17,7,10,6,2
10407,"高雄市","大寮區上寮里",5,2,3,5,3,2,3,3
10407,"高雄市","大寮區翁園里",3,3,0,2,1,1,5,2
10407,"高雄市","大寮區溪寮里",2,1,1,4,3,1,3,1
10407,"高雄市","大寮區新厝里",3,1,2,3,1,2,1,0
10407,"高雄市","大寮區義和里",1,1,0,4,3,1,2,1
10407,"高雄市","大寮區義仁里",1,1,0,4,4,0,2,0
10407,"高雄市","大寮區永芳里",8,5,3,7,5,2,2,2
10407,"高雄市","大寮區昭明里",5,3,2,5,3,2,5,4
10407,"高雄市","大寮區中興里",10,6,4,22,16,6,7,5
10407,"高雄市","大寮區中庄里",17,9,8,6,3,3,17,3
10407,"高雄市","大寮區忠義里",1,0,1,2,1,1,0,0
10407,"高雄市","大社區保安里",3,3,0,3,1,2,4,0
10407,"高雄市","大社區保社里",3,2,1,5,3,2,0,2
10407,"高雄市","大社區翠屏里",3,2,1,2,1,1,3,1
10407,"高雄市","大社區大社里",8,3,5,8,8,0,2,2
10407,"高雄市","大社區觀音里",10,6,4,8,5,3,4,3
10407,"高雄市","大社區嘉誠里",2,1,1,2,0,2,0,0
10407,"高雄市","大社區三奶里",2,2,0,10,4,6,1,0
10407,"高雄市","大社區神農里",11,8,3,7,5,2,3,4
10407,"高雄市","大社區中里里",7,5,2,7,5,2,3,0
10407,"高雄市","大樹區大坑里",3,2,1,1,1,0,0,0
10407,"高雄市","大樹區大樹里",2,1,1,5,3,2,5,4
10407,"高雄市","大樹區姑山里",3,3,0,5,3,2,2,0
10407,"高雄市","大樹區和山里",0,0,0,3,2,1,1,1
10407,"高雄市","大樹區井腳里",1,1,0,3,2,1,1,0
10407,"高雄市","大樹區九曲里",4,3,1,2,2,0,6,3
10407,"高雄市","大樹區久堂里",5,3,2,5,4,1,4,0
10407,"高雄市","大樹區龍目里",0,0,0,1,0,1,1,0
10407,"高雄市","大樹區三和里",1,0,1,2,1,1,0,0
10407,"高雄市","大樹區檨腳里",4,1,3,4,2,2,4,1
10407,"高雄市","大樹區水安里",3,1,2,4,2,2,1,1
10407,"高雄市","大樹區水寮里",3,2,1,7,3,4,3,0
10407,"高雄市","大樹區統嶺里",1,1,0,1,1,0,2,0
10407,"高雄市","大樹區溪埔里",9,3,6,2,0,2,1,0
10407,"高雄市","大樹區小坪里",4,4,0,4,2,2,2,0
10407,"高雄市","大樹區興山里",2,2,0,4,3,1,1,0
10407,"高雄市","大樹區興田里",1,1,0,3,1,2,1,1
10407,"高雄市","大樹區竹寮里",5,2,3,5,3,2,5,2
10407,"高雄市","鳳山區保安里",13,5,8,5,3,2,8,3
10407,"高雄市","鳳山區北門里",5,2,3,3,2,1,6,5
10407,"高雄市","鳳山區曹公里",5,1,4,6,4,2,0,0
10407,"高雄市","鳳山區成功里",0,0,0,1,1,0,1,0
10407,"高雄市","鳳山區誠德里",2,1,1,4,3,1,2,1
10407,"高雄市","鳳山區誠信里",3,2,1,1,1,0,1,1
10407,"高雄市","鳳山區誠義里",4,3,1,2,1,1,3,3
10407,"高雄市","鳳山區誠智里",7,3,4,3,1,2,2,1
10407,"高雄市","鳳山區大德里",11,4,7,3,2,1,8,3
10407,"高雄市","鳳山區東門里",7,2,5,6,2,4,3,4
10407,"高雄市","鳳山區二甲里",11,5,6,10,8,2,5,4
10407,"高雄市","鳳山區鳳東里",12,9,3,7,5,2,2,3
10407,"高雄市","鳳山區鳳崗里",0,0,0,1,0,1,0,0
10407,"高雄市","鳳山區福誠里",5,3,2,3,2,1,3,0
10407,"高雄市","鳳山區福祥里",7,3,4,2,2,0,4,1
10407,"高雄市","鳳山區福興里",10,3,7,7,6,1,4,4
10407,"高雄市","鳳山區富甲里",1,0,1,2,2,0,1,3
10407,"高雄市","鳳山區富榮里",5,3,2,3,3,0,1,0
10407,"高雄市","鳳山區光明里",2,1,1,0,0,0,1,2
10407,"高雄市","鳳山區國富里",2,1,1,3,1,2,5,1
10407,"高雄市","鳳山區國光里",5,2,3,3,3,0,2,2
10407,"高雄市","鳳山區國隆里",3,3,0,2,1,1,3,2
10407,"高雄市","鳳山區國泰里",6,2,4,2,2,0,3,2
10407,"高雄市","鳳山區過埤里",29,17,12,8,3,5,13,8
10407,"高雄市","鳳山區海光里",2,2,0,6,3,3,1,0
10407,"高雄市","鳳山區海洋里",5,1,4,2,1,1,1,1
10407,"高雄市","鳳山區和德里",4,3,1,2,2,0,2,2
10407,"高雄市","鳳山區和興里",4,3,1,5,2,3,3,1
10407,"高雄市","鳳山區老爺里",9,4,5,12,6,6,6,5
10407,"高雄市","鳳山區龍成里",5,3,2,1,1,0,0,1
10407,"高雄市","鳳山區南成里",27,14,13,6,4,2,7,5
10407,"高雄市","鳳山區南和里",6,5,1,5,3,2,1,1
10407,"高雄市","鳳山區南興里",1,1,0,2,1,1,0,0
10407,"高雄市","鳳山區埤頂里",7,4,3,7,4,3,3,1
10407,"高雄市","鳳山區瑞興里",7,4,3,5,1,4,9,2
10407,"高雄市","鳳山區瑞竹里",8,4,4,5,4,1,4,0
10407,"高雄市","鳳山區三民里",5,3,2,2,2,0,3,1
10407,"高雄市","鳳山區善美里",8,6,2,7,5,2,4,1
10407,"高雄市","鳳山區生明里",1,1,0,3,2,1,1,1
10407,"高雄市","鳳山區天興里",5,1,4,4,4,0,4,2
10407,"高雄市","鳳山區文德里",14,6,8,8,4,4,10,6
10407,"高雄市","鳳山區文福里",20,7,13,7,3,4,12,6
10407,"高雄市","鳳山區文衡里",8,3,5,4,2,2,2,1
10407,"高雄市","鳳山區文華里",18,13,5,19,12,7,9,6
10407,"高雄市","鳳山區文山里",13,6,7,7,4,3,4,2
10407,"高雄市","鳳山區文英里",12,5,7,10,5,5,3,0
10407,"高雄市","鳳山區五福里",2,2,0,4,3,1,2,3
10407,"高雄市","鳳山區武漢里",9,3,6,5,3,2,8,2
10407,"高雄市","鳳山區武慶里",4,2,2,2,1,1,1,1
10407,"高雄市","鳳山區武松里",4,3,1,3,1,2,4,0
10407,"高雄市","鳳山區縣口里",3,1,2,1,0,1,0,0
10407,"高雄市","鳳山區縣衙里",2,1,1,1,1,0,0,0
10407,"高雄市","鳳山區協和里",7,2,5,5,3,2,4,1
10407,"高雄市","鳳山區新富里",5,4,1,2,1,1,4,3
10407,"高雄市","鳳山區新甲里",3,1,2,5,3,2,3,1
10407,"高雄市","鳳山區新樂里",7,3,4,6,2,4,2,1
10407,"高雄市","鳳山區新強里",11,6,5,4,1,3,3,3
10407,"高雄市","鳳山區新泰里",5,3,2,3,3,0,2,0
10407,"高雄市","鳳山區新武里",3,3,0,2,1,1,3,3
10407,"高雄市","鳳山區新興里",4,2,2,3,1,2,2,3
10407,"高雄市","鳳山區興仁里",5,3,2,7,4,3,1,2
10407,"高雄市","鳳山區興中里",2,2,0,0,0,0,1,1
10407,"高雄市","鳳山區一甲里",12,6,6,7,6,1,2,2
10407,"高雄市","鳳山區鎮北里",12,8,4,8,4,4,10,3
10407,"高雄市","鳳山區鎮東里",4,3,1,2,1,1,2,1
10407,"高雄市","鳳山區鎮南里",11,6,5,6,5,1,6,8
10407,"高雄市","鳳山區鎮西里",7,6,1,8,5,3,2,3
10407,"高雄市","鳳山區正義里",10,5,5,8,4,4,8,4
10407,"高雄市","鳳山區中和里",7,5,2,4,3,1,4,0
10407,"高雄市","鳳山區中崙里",7,3,4,2,1,1,1,1
10407,"高雄市","鳳山區中民里",10,3,7,3,2,1,5,3
10407,"高雄市","鳳山區中榮里",7,4,3,2,1,1,3,2
10407,"高雄市","鳳山區中正里",5,1,4,12,8,4,4,0
10407,"高雄市","鳳山區忠誠里",9,4,5,5,1,4,3,1
10407,"高雄市","鳳山區忠孝里",5,4,1,5,3,2,4,3
10407,"高雄市","鳳山區忠義里",3,2,1,7,5,2,3,5
10407,"高雄市","岡山區白米里",2,1,1,2,2,0,0,1
10407,"高雄市","岡山區本洲里",4,3,1,6,4,2,1,0
10407,"高雄市","岡山區碧紅里",9,6,3,4,3,1,7,4
10407,"高雄市","岡山區程香里",11,7,4,5,5,0,2,4
10407,"高雄市","岡山區大遼里",5,3,2,4,3,1,1,1
10407,"高雄市","岡山區大莊里",4,0,4,3,2,1,0,2
10407,"高雄市","岡山區福興里",2,2,0,3,2,1,0,1
10407,"高雄市","岡山區岡山里",6,3,3,7,1,6,3,0
10407,"高雄市","岡山區和平里",1,0,1,0,0,0,0,0
10407,"高雄市","岡山區後紅里",5,1,4,6,5,1,3,3
10407,"高雄市","岡山區後協里",11,3,8,10,5,5,5,3
10407,"高雄市","岡山區華崗里",2,1,1,3,1,2,1,0
10407,"高雄市","岡山區嘉峰里",3,1,2,3,1,2,0,0
10407,"高雄市","岡山區嘉興里",7,3,4,7,5,2,4,2
10407,"高雄市","岡山區劉厝里",0,0,0,3,0,3,0,0
10407,"高雄市","岡山區平安里",7,3,4,2,1,1,0,0
10407,"高雄市","岡山區前峰里",3,3,0,2,2,0,1,2
10407,"高雄市","岡山區仁壽里",4,2,2,4,3,1,1,0
10407,"高雄市","岡山區仁義里",1,0,1,4,3,1,2,0
10407,"高雄市","岡山區三和里",0,0,0,1,1,0,1,0
10407,"高雄市","岡山區石潭里",4,4,0,2,2,0,1,1
10407,"高雄市","岡山區壽峰里",3,2,1,0,0,0,1,0
10407,"高雄市","岡山區壽天里",5,5,0,4,2,2,4,1
10407,"高雄市","岡山區台上里",9,5,4,4,3,1,4,2
10407,"高雄市","岡山區潭底里",4,3,1,2,2,0,0,1
10407,"高雄市","岡山區灣裡里",6,5,1,3,3,0,4,1
10407,"高雄市","岡山區維仁里",3,3,0,4,2,2,1,2
10407,"高雄市","岡山區為隨里",0,0,0,1,0,1,0,1
10407,"高雄市","岡山區協和里",9,4,5,1,0,1,5,2
10407,"高雄市","岡山區協榮里",5,2,3,4,2,2,6,1
10407,"高雄市","岡山區信義里",2,1,1,11,7,4,1,1
10407,"高雄市","岡山區忠孝里",5,2,3,8,4,4,2,3
10407,"高雄市","岡山區竹圍里",14,5,9,5,3,2,6,4
10407,"高雄市","鼓山區寶樹里",0,0,0,4,3,1,2,1
10407,"高雄市","鼓山區登山里",2,2,0,4,2,2,1,1
10407,"高雄市","鼓山區峰南里",0,0,0,4,2,2,0,0
10407,"高雄市","鼓山區鼓峰里",0,0,0,5,2,3,1,3
10407,"高雄市","鼓山區鼓岩里",1,1,0,3,2,1,0,1
10407,"高雄市","鼓山區光化里",1,1,0,1,1,0,0,1
10407,"高雄市","鼓山區光榮里",8,4,4,7,6,1,1,2
10407,"高雄市","鼓山區河邊里",3,1,2,2,1,1,1,1
10407,"高雄市","鼓山區厚生里",5,2,3,8,5,3,3,1
10407,"高雄市","鼓山區華豐里",4,2,2,6,2,4,2,1
10407,"高雄市","鼓山區惠安里",0,0,0,4,3,1,1,0
10407,"高雄市","鼓山區建國里",3,2,1,1,0,1,3,1
10407,"高雄市","鼓山區麗興里",1,0,1,3,1,2,0,1
10407,"高雄市","鼓山區龍井里",0,0,0,4,4,0,1,0
10407,"高雄市","鼓山區龍水里",49,30,19,13,7,6,27,11
10407,"高雄市","鼓山區龍子里",27,11,16,9,7,2,12,8
10407,"高雄市","鼓山區綠川里",2,2,0,3,1,2,2,1
10407,"高雄市","鼓山區民強里",5,4,1,4,2,2,2,1
10407,"高雄市","鼓山區民族里",3,1,2,1,0,1,1,3
10407,"高雄市","鼓山區明誠里",26,17,9,15,4,11,15,14
10407,"高雄市","鼓山區內惟里",0,0,0,5,5,0,1,0
10407,"高雄市","鼓山區平和里",4,3,1,2,0,2,2,3
10407,"高雄市","鼓山區前峰里",6,5,1,3,2,1,3,6
10407,"高雄市","鼓山區山下里",0,0,0,0,0,0,2,2
10407,"高雄市","鼓山區哨船頭里",1,1,0,1,1,0,1,1
10407,"高雄市","鼓山區壽山里",1,1,0,7,5,2,1,1
10407,"高雄市","鼓山區樹德里",2,2,0,2,0,2,1,0
10407,"高雄市","鼓山區桃源里",1,1,0,1,1,0,1,0
10407,"高雄市","鼓山區維生里",1,1,0,2,1,1,3,1
10407,"高雄市","鼓山區新民里",0,0,0,2,2,0,2,0
10407,"高雄市","鼓山區興宗里",0,0,0,8,4,4,0,1
10407,"高雄市","鼓山區雄峰里",3,3,0,3,3,0,1,1
10407,"高雄市","鼓山區延平里",1,0,1,4,1,3,2,0
10407,"高雄市","鼓山區裕豐里",1,1,0,5,2,3,2,0
10407,"高雄市","鼓山區裕興里",10,5,5,1,1,0,2,2
10407,"高雄市","鼓山區正德里",3,1,2,6,4,2,1,2
10407,"高雄市","鼓山區忠正里",5,3,2,9,7,2,3,1
10407,"高雄市","鼓山區自強里",0,0,0,2,2,0,0,1
10407,"高雄市","湖內區大湖里",8,3,5,7,3,4,5,0
10407,"高雄市","湖內區公舘里",1,1,0,4,1,3,0,1
10407,"高雄市","湖內區海埔里",3,3,0,0,0,0,1,1
10407,"高雄市","湖內區海山里",1,0,1,3,2,1,0,0
10407,"高雄市","湖內區湖東里",3,1,2,2,2,0,3,2
10407,"高雄市","湖內區湖內里",3,0,3,4,2,2,3,1
10407,"高雄市","湖內區劉家里",1,0,1,4,3,1,1,1
10407,"高雄市","湖內區太爺里",1,1,0,1,1,0,0,0
10407,"高雄市","湖內區田尾里",0,0,0,4,3,1,0,0
10407,"高雄市","湖內區文賢里",0,0,0,1,1,0,0,1
10407,"高雄市","湖內區葉厝里",6,2,4,2,0,2,0,2
10407,"高雄市","湖內區逸賢里",0,0,0,0,0,0,0,2
10407,"高雄市","湖內區中賢里",2,1,1,3,2,1,6,0
10407,"高雄市","湖內區忠興里",0,0,0,2,0,2,0,1
10407,"高雄市","茄萣區白雲里",4,2,2,4,3,1,3,3
10407,"高雄市","茄萣區保定里",8,4,4,5,1,4,0,0
10407,"高雄市","茄萣區大定里",1,0,1,1,1,0,1,2
10407,"高雄市","茄萣區福德里",1,0,1,1,1,0,0,0
10407,"高雄市","茄萣區光定里",1,1,0,3,3,0,1,0
10407,"高雄市","茄萣區和協里",1,0,1,1,1,0,0,1
10407,"高雄市","茄萣區吉定里",2,1,1,2,1,1,1,0
10407,"高雄市","茄萣區嘉安里",2,1,1,1,1,0,2,0
10407,"高雄市","茄萣區嘉賜里",6,3,3,8,6,2,2,1
10407,"高雄市","茄萣區嘉定里",1,0,1,8,5,3,2,0
10407,"高雄市","茄萣區嘉福里",0,0,0,1,1,0,1,2
10407,"高雄市","茄萣區嘉樂里",5,2,3,2,1,1,6,0
10407,"高雄市","茄萣區嘉泰里",1,1,0,5,2,3,2,0
10407,"高雄市","茄萣區崎漏里",10,5,5,3,1,2,5,2
10407,"高雄市","茄萣區萬福里",0,0,0,3,3,0,0,2
10407,"高雄市","甲仙區寶隆里",1,1,0,0,0,0,0,1
10407,"高雄市","甲仙區大田里",1,1,0,3,2,1,1,1
10407,"高雄市","甲仙區東安里",0,0,0,1,1,0,0,0
10407,"高雄市","甲仙區關山里",0,0,0,3,2,1,0,2
10407,"高雄市","甲仙區和安里",2,0,2,2,1,1,0,0
10407,"高雄市","甲仙區西安里",0,0,0,2,0,2,0,1
10407,"高雄市","甲仙區小林里",0,0,0,0,0,0,0,0
10407,"高雄市","林園區北汕里",3,3,0,5,4,1,1,1
10407,"高雄市","林園區頂厝里",7,4,3,7,4,3,3,3
10407,"高雄市","林園區東林里",4,2,2,3,2,1,1,3
10407,"高雄市","林園區東汕里",1,0,1,0,0,0,1,0
10407,"高雄市","林園區鳳芸里",4,2,2,2,1,1,1,0
10407,"高雄市","林園區港埔里",3,3,0,2,1,1,1,0
10407,"高雄市","林園區港嘴里",3,1,2,5,5,0,2,3
10407,"高雄市","林園區龔厝里",3,1,2,3,2,1,1,0
10407,"高雄市","林園區廣應里",11,9,2,3,1,2,2,2
10407,"高雄市","林園區林家里",1,1,0,1,0,1,1,0
10407,"高雄市","林園區林內里",3,1,2,2,2,0,5,1
10407,"高雄市","林園區林園里",3,2,1,7,3,4,0,1
10407,"高雄市","林園區仁愛里",2,0,2,2,2,0,5,0
10407,"高雄市","林園區潭頭里",3,0,3,6,4,2,0,1
10407,"高雄市","林園區王公里",4,3,1,5,2,3,1,3
10407,"高雄市","林園區文賢里",8,4,4,3,3,0,3,1
10407,"高雄市","林園區五福里",5,3,2,4,3,1,3,5
10407,"高雄市","林園區溪州里",9,2,7,13,10,3,3,2
10407,"高雄市","林園區西汕里",2,0,2,1,1,0,0,0
10407,"高雄市","林園區西溪里",7,3,4,2,1,1,6,2
10407,"高雄市","林園區中厝里",2,2,0,11,7,4,3,2
10407,"高雄市","林園區中門里",5,4,1,4,1,3,1,2
10407,"高雄市","林園區中汕里",5,2,3,4,4,0,2,1
10407,"高雄市","林園區中芸里",3,2,1,5,5,0,0,2
10407,"高雄市","苓雅區安祥里",0,0,0,4,4,0,3,2
10407,"高雄市","苓雅區博仁里",1,1,0,1,1,0,2,0
10407,"高雄市","苓雅區朝陽里",1,0,1,1,0,1,1,2
10407,"高雄市","苓雅區城北里",1,1,0,5,2,3,1,0
10407,"高雄市","苓雅區城東里",0,0,0,5,2,3,0,4
10407,"高雄市","苓雅區城西里",1,1,0,0,0,0,1,0
10407,"高雄市","苓雅區福地里",2,2,0,4,3,1,4,3
10407,"高雄市","苓雅區福東里",5,2,3,3,1,2,2,0
10407,"高雄市","苓雅區福海里",3,0,3,0,0,0,1,0
10407,"高雄市","苓雅區福居里",7,6,1,5,3,2,1,3
10407,"高雄市","苓雅區福康里",1,1,0,0,0,0,2,0
10407,"高雄市","苓雅區福隆里",5,3,2,1,1,0,1,0
10407,"高雄市","苓雅區福南里",1,1,0,2,2,0,1,0
10407,"高雄市","苓雅區福人里",1,0,1,4,3,1,2,0
10407,"高雄市","苓雅區福壽里",1,0,1,5,2,3,0,1
10407,"高雄市","苓雅區福西里",2,1,1,2,2,0,2,0
10407,"高雄市","苓雅區福祥里",1,1,0,4,2,2,0,0
10407,"高雄市","苓雅區鼓中里",0,0,0,1,0,1,1,0
10407,"高雄市","苓雅區光華里",0,0,0,2,2,0,1,0
10407,"高雄市","苓雅區廣澤里",2,1,1,7,5,2,3,1
10407,"高雄市","苓雅區和煦里",3,1,2,3,3,0,2,2
10407,"高雄市","苓雅區華堂里",4,3,1,2,0,2,1,1
10407,"高雄市","苓雅區建軍里",2,1,1,5,5,0,1,2
10407,"高雄市","苓雅區凱旋里",1,0,1,3,1,2,4,2
10407,"高雄市","苓雅區林安里",4,1,3,2,2,0,1,2
10407,"高雄市","苓雅區林德里",1,1,0,4,3,1,0,0
10407,"高雄市","苓雅區林富里",0,0,0,1,1,0,3,0
10407,"高雄市","苓雅區林貴里",2,2,0,0,0,0,1,1
10407,"高雄市","苓雅區林華里",7,2,5,6,2,4,3,1
10407,"高雄市","苓雅區林靖里",2,1,1,2,2,0,1,2
10407,"高雄市","苓雅區林南里",4,2,2,3,2,1,2,0
10407,"高雄市","苓雅區林泉里",5,3,2,1,0,1,1,2
10407,"高雄市","苓雅區林榮里",2,2,0,4,4,0,5,2
10407,"高雄市","苓雅區林圍里",2,1,1,2,1,1,1,0
10407,"高雄市","苓雅區林西里",0,0,0,0,0,0,0,2
10407,"高雄市","苓雅區林興里",1,0,1,3,1,2,2,0
10407,"高雄市","苓雅區林中里",4,2,2,5,3,2,1,2
10407,"高雄市","苓雅區苓東里",0,0,0,2,1,1,3,2
10407,"高雄市","苓雅區苓昇里",3,1,2,6,6,0,1,0
10407,"高雄市","苓雅區苓雅里",4,2,2,2,0,2,0,0
10407,"高雄市","苓雅區苓中里",3,1,2,0,0,0,1,0
10407,"高雄市","苓雅區苓洲里",2,0,2,2,0,2,3,0
10407,"高雄市","苓雅區美田里",1,1,0,1,1,0,2,1
10407,"高雄市","苓雅區民主里",4,2,2,5,1,4,4,0
10407,"高雄市","苓雅區普天里",6,4,2,3,1,2,3,0
10407,"高雄市","苓雅區普照里",0,0,0,3,0,3,4,4
10407,"高雄市","苓雅區晴朗里",1,1,0,2,2,0,1,1
10407,"高雄市","苓雅區人和里",0,0,0,2,1,1,2,1
10407,"高雄市","苓雅區仁政里",2,1,1,0,0,0,3,0
10407,"高雄市","苓雅區日中里",1,1,0,6,1,5,1,3
10407,"高雄市","苓雅區尚義里",4,3,1,2,1,1,1,1
10407,"高雄市","苓雅區田西里",2,1,1,3,3,0,1,2
10407,"高雄市","苓雅區同慶里",4,2,2,3,2,1,2,0
10407,"高雄市","苓雅區衛武里",1,1,0,5,3,2,2,1
10407,"高雄市","苓雅區文昌里",6,4,2,6,4,2,4,1
10407,"高雄市","苓雅區五福里",5,4,1,12,10,2,2,1
10407,"高雄市","苓雅區五權里",4,1,3,6,3,3,5,2
10407,"高雄市","苓雅區意誠里",4,1,3,1,1,0,10,4
10407,"高雄市","苓雅區英明里",3,1,2,3,2,1,2,0
10407,"高雄市","苓雅區永康里",2,1,1,8,5,3,0,0
10407,"高雄市","苓雅區正大里",10,6,4,7,4,3,6,0
10407,"高雄市","苓雅區正道里",9,4,5,6,2,4,3,1
10407,"高雄市","苓雅區正仁里",5,4,1,0,0,0,2,0
10407,"高雄市","苓雅區正文里",4,4,0,2,1,1,3,1
10407,"高雄市","苓雅區正心里",3,2,1,6,5,1,8,2
10407,"高雄市","苓雅區正言里",5,3,2,3,0,3,3,1
10407,"高雄市","苓雅區正義里",4,2,2,3,2,1,1,0
10407,"高雄市","苓雅區中正里",3,2,1,4,2,2,0,1
10407,"高雄市","苓雅區奏捷里",1,0,1,2,1,1,0,1
10407,"高雄市","六龜區寶來里",2,1,1,2,1,1,0,2
10407,"高雄市","六龜區大津里",0,0,0,1,1,0,0,0
10407,"高雄市","六龜區荖濃里",4,2,2,4,4,0,0,1
10407,"高雄市","六龜區六龜里",1,0,1,6,4,2,1,0
10407,"高雄市","六龜區文武里",2,1,1,6,3,3,0,2
10407,"高雄市","六龜區新發里",2,2,0,2,2,0,1,1
10407,"高雄市","六龜區新寮里",1,1,0,0,0,0,0,1
10407,"高雄市","六龜區新威里",1,1,0,0,0,0,0,1
10407,"高雄市","六龜區新興里",2,0,2,1,1,0,0,0
10407,"高雄市","六龜區興龍里",2,1,1,2,1,1,1,2
10407,"高雄市","六龜區義寶里",0,0,0,3,0,3,0,1
10407,"高雄市","六龜區中興里",1,0,1,3,2,1,0,0
10407,"高雄市","路竹區北嶺里",3,3,0,1,1,0,1,0
10407,"高雄市","路竹區頂寮里",5,2,3,1,0,1,2,0
10407,"高雄市","路竹區後鄉里",0,0,0,0,0,0,2,0
10407,"高雄市","路竹區甲北里",3,2,1,4,2,2,3,0
10407,"高雄市","路竹區甲南里",1,1,0,5,4,1,4,1
10407,"高雄市","路竹區三爺里",0,0,0,2,1,1,0,0
10407,"高雄市","路竹區社東里",2,1,1,4,4,0,0,0
10407,"高雄市","路竹區社南里",6,3,3,6,4,2,4,1
10407,"高雄市","路竹區社西里",1,1,0,1,0,1,0,0
10407,"高雄市","路竹區社中里",3,3,0,2,1,1,1,0
10407,"高雄市","路竹區文北里",4,3,1,2,1,1,1,1
10407,"高雄市","路竹區文南里",4,2,2,3,3,0,2,0
10407,"高雄市","路竹區下坑里",5,3,2,5,3,2,3,4
10407,"高雄市","路竹區新達里",1,1,0,2,1,1,0,0
10407,"高雄市","路竹區鴨寮里",5,1,4,2,2,0,0,1
10407,"高雄市","路竹區竹東里",6,5,1,2,2,0,5,1
10407,"高雄市","路竹區竹滬里",5,2,3,5,5,0,1,1
10407,"高雄市","路竹區竹南里",6,3,3,4,2,2,3,2
10407,"高雄市","路竹區竹西里",4,2,2,4,3,1,0,0
10407,"高雄市","路竹區竹園里",2,2,0,3,2,1,2,0
10407,"高雄市","茂林區多納里",2,2,0,2,1,1,0,0
10407,"高雄市","茂林區茂林里",2,1,1,2,1,1,0,1
10407,"高雄市","茂林區萬山里",2,2,0,0,0,0,0,0
10407,"高雄市","美濃區德興里",1,1,0,5,3,2,0,1
10407,"高雄市","美濃區東門里",0,0,0,4,3,1,1,0
10407,"高雄市","美濃區福安里",4,1,3,4,2,2,2,3
10407,"高雄市","美濃區廣德里",1,0,1,5,4,1,1,1
10407,"高雄市","美濃區廣林里",0,0,0,2,0,2,3,1
10407,"高雄市","美濃區合和里",5,4,1,10,9,1,1,0
10407,"高雄市","美濃區吉東里",4,2,2,6,5,1,1,4
10407,"高雄市","美濃區吉和里",2,1,1,2,0,2,1,1
10407,"高雄市","美濃區吉洋里",1,0,1,4,1,3,0,0
10407,"高雄市","美濃區龍肚里",0,0,0,7,6,1,3,0
10407,"高雄市","美濃區龍山里",2,1,1,5,3,2,1,3
10407,"高雄市","美濃區祿興里",2,2,0,10,5,5,0,3
10407,"高雄市","美濃區瀰濃里",2,1,1,6,2,4,2,2
10407,"高雄市","美濃區清水里",1,1,0,8,3,5,1,0
10407,"高雄市","美濃區獅山里",2,0,2,3,1,2,3,0
10407,"高雄市","美濃區泰安里",3,2,1,2,0,2,0,0
10407,"高雄市","美濃區興隆里",3,2,1,3,2,1,1,1
10407,"高雄市","美濃區中壇里",4,2,2,4,3,1,3,0
10407,"高雄市","美濃區中圳里",2,2,0,2,1,1,0,0
10407,"高雄市","彌陀區光和里",1,1,0,2,2,0,1,0
10407,"高雄市","彌陀區過港里",1,0,1,4,2,2,1,1
10407,"高雄市","彌陀區海尾里",1,0,1,2,1,1,1,0
10407,"高雄市","彌陀區舊港里",2,2,0,4,3,1,2,1
10407,"高雄市","彌陀區漯底里",0,0,0,3,3,0,1,0
10407,"高雄市","彌陀區彌靖里",3,2,1,2,1,1,2,0
10407,"高雄市","彌陀區彌仁里",1,0,1,1,0,1,0,0
10407,"高雄市","彌陀區彌壽里",0,0,0,1,0,1,1,1
10407,"高雄市","彌陀區彌陀里",0,0,0,2,1,1,2,0
10407,"高雄市","彌陀區南寮里",1,1,0,5,3,2,3,2
10407,"高雄市","彌陀區文安里",5,2,3,2,0,2,0,1
10407,"高雄市","彌陀區鹽埕里",1,0,1,5,4,1,1,0
10407,"高雄市","那瑪夏區達卡努瓦里",2,0,2,1,1,0,2,0
10407,"高雄市","那瑪夏區瑪雅里",0,0,0,3,2,1,1,0
10407,"高雄市","那瑪夏區南沙魯里",1,1,0,0,0,0,1,0
10407,"高雄市","楠梓區翠屏里",23,12,11,16,11,5,15,8
10407,"高雄市","楠梓區大昌里",2,1,1,3,1,2,1,1
10407,"高雄市","楠梓區東寧里",8,5,3,4,1,3,6,4
10407,"高雄市","楠梓區福昌里",3,1,2,2,2,0,3,2
10407,"高雄市","楠梓區廣昌里",0,0,0,4,3,1,3,1
10407,"高雄市","楠梓區國昌里",2,0,2,4,3,1,6,1
10407,"高雄市","楠梓區和昌里",1,0,1,4,2,2,2,2
10407,"高雄市","楠梓區宏昌里",1,0,1,4,2,2,5,2
10407,"高雄市","楠梓區宏南里",0,0,0,3,2,1,1,0
10407,"高雄市","楠梓區宏榮里",4,2,2,5,5,0,0,0
10407,"高雄市","楠梓區宏毅里",3,2,1,7,5,2,1,0
10407,"高雄市","楠梓區惠豐里",7,4,3,7,4,3,4,3
10407,"高雄市","楠梓區惠民里",6,4,2,8,5,3,5,0
10407,"高雄市","楠梓區惠楠里",1,1,0,7,3,4,4,1
10407,"高雄市","楠梓區加昌里",12,8,4,10,4,6,6,4
10407,"高雄市","楠梓區建昌里",2,1,1,6,4,2,1,2
10407,"高雄市","楠梓區金田里",4,1,3,5,1,4,2,1
10407,"高雄市","楠梓區錦屏里",3,0,3,6,5,1,4,4
10407,"高雄市","楠梓區久昌里",4,2,2,3,2,1,1,2
10407,"高雄市","楠梓區藍田里",9,5,4,3,2,1,5,4
10407,"高雄市","楠梓區隆昌里",5,1,4,7,3,4,4,1
10407,"高雄市","楠梓區清豐里",52,33,19,17,13,4,19,6
10407,"高雄市","楠梓區慶昌里",1,1,0,5,3,2,4,1
10407,"高雄市","楠梓區仁昌里",7,6,1,6,3,3,3,5
10407,"高雄市","楠梓區稔田里",3,2,1,3,1,2,0,1
10407,"高雄市","楠梓區瑞屏里",9,5,4,6,6,0,8,3
10407,"高雄市","楠梓區盛昌里",4,3,1,5,3,2,4,3
10407,"高雄市","楠梓區泰昌里",1,0,1,6,3,3,0,1
10407,"高雄市","楠梓區五常里",11,5,6,8,4,4,8,5
10407,"高雄市","楠梓區享平里",3,1,2,6,4,2,2,2
10407,"高雄市","楠梓區興昌里",8,5,3,7,4,3,6,2
10407,"高雄市","楠梓區秀昌里",4,1,3,4,3,1,3,2
10407,"高雄市","楠梓區玉屏里",4,3,1,5,2,3,1,1
10407,"高雄市","楠梓區裕昌里",10,5,5,2,1,1,3,8
10407,"高雄市","楠梓區中和里",5,3,2,5,5,0,0,0
10407,"高雄市","楠梓區中興里",5,3,2,0,0,0,1,0
10407,"高雄市","楠梓區中陽里",2,1,1,5,0,5,3,1
10407,"高雄市","內門區東埔里",1,1,0,1,0,1,0,0
10407,"高雄市","內門區溝坪里",5,2,3,3,3,0,0,0
10407,"高雄市","內門區觀亭里",0,0,0,3,0,3,1,0
10407,"高雄市","內門區光興里",2,0,2,3,1,2,1,0
10407,"高雄市","內門區金竹里",1,1,0,2,2,0,0,0
10407,"高雄市","內門區木柵里",1,0,1,3,1,2,0,0
10407,"高雄市","內門區內東里",0,0,0,3,3,0,1,0
10407,"高雄市","內門區內豊里",2,1,1,3,1,2,0,0
10407,"高雄市","內門區內門里",0,0,0,2,2,0,3,0
10407,"高雄市","內門區內南里",1,0,1,3,0,3,0,1
10407,"高雄市","內門區內興里",1,0,1,2,1,1,0,0
10407,"高雄市","內門區瑞山里",0,0,0,0,0,0,0,0
10407,"高雄市","內門區三平里",0,0,0,0,0,0,0,0
10407,"高雄市","內門區石坑里",0,0,0,1,1,0,1,0
10407,"高雄市","內門區永富里",1,1,0,0,0,0,0,0
10407,"高雄市","內門區永吉里",0,0,0,1,1,0,0,0
10407,"高雄市","內門區永興里",0,0,0,2,1,1,0,0
10407,"高雄市","內門區中埔里",0,0,0,1,1,0,0,1
10407,"高雄市","鳥松區大華里",13,6,7,7,5,2,5,2
10407,"高雄市","鳥松區大竹里",2,2,0,0,0,0,0,0
10407,"高雄市","鳥松區坔埔里",5,4,1,4,1,3,2,6
10407,"高雄市","鳥松區華美里",3,2,1,2,1,1,5,1
10407,"高雄市","鳥松區夢裡里",3,1,2,3,2,1,8,2
10407,"高雄市","鳥松區鳥松里",14,6,8,8,5,3,7,6
10407,"高雄市","鳥松區仁美里",7,1,6,7,5,2,11,2
10407,"高雄市","旗津區安順里",2,2,0,1,1,0,2,0
10407,"高雄市","旗津區北汕里",5,2,3,6,3,3,0,3
10407,"高雄市","旗津區慈愛里",4,2,2,5,1,4,2,0
10407,"高雄市","旗津區復興里",1,0,1,3,2,1,2,4
10407,"高雄市","旗津區南汕里",4,2,2,3,1,2,2,1
10407,"高雄市","旗津區旗下里",3,1,2,1,1,0,2,2
10407,"高雄市","旗津區上竹里",7,3,4,3,3,0,1,1
10407,"高雄市","旗津區實踐里",0,0,0,5,2,3,0,1
10407,"高雄市","旗津區永安里",6,4,2,4,3,1,2,0
10407,"高雄市","旗津區振興里",4,2,2,3,2,1,2,0
10407,"高雄市","旗津區中華里",2,0,2,2,2,0,0,0
10407,"高雄市","旗津區中興里",10,2,8,2,1,1,3,0
10407,"高雄市","旗津區中洲里",4,2,2,2,1,1,2,0
10407,"高雄市","旗山區大德里",2,1,1,4,2,2,2,1
10407,"高雄市","旗山區大林里",2,0,2,1,0,1,1,1
10407,"高雄市","旗山區大山里",0,0,0,6,3,3,0,0
10407,"高雄市","旗山區東昌里",0,0,0,2,0,2,0,0
10407,"高雄市","旗山區東平里",3,0,3,6,1,5,2,0
10407,"高雄市","旗山區廣福里",1,1,0,0,0,0,0,0
10407,"高雄市","旗山區鯤洲里",1,1,0,3,2,1,1,1
10407,"高雄市","旗山區湄洲里",1,1,0,7,3,4,0,1
10407,"高雄市","旗山區南勝里",4,0,4,7,4,3,2,2
10407,"高雄市","旗山區南洲里",1,1,0,4,1,3,2,0
10407,"高雄市","旗山區瑞吉里",2,1,1,6,3,3,1,1
10407,"高雄市","旗山區三協里",3,0,3,5,2,3,1,2
10407,"高雄市","旗山區上洲里",1,0,1,1,1,0,0,0
10407,"高雄市","旗山區太平里",3,3,0,7,3,4,2,4
10407,"高雄市","旗山區新光里",1,0,1,2,2,0,1,0
10407,"高雄市","旗山區永和里",2,1,1,3,2,1,5,1
10407,"高雄市","旗山區圓富里",5,3,2,3,1,2,0,0
10407,"高雄市","旗山區中寮里",0,0,0,0,0,0,0,0
10407,"高雄市","旗山區中正里",0,0,0,4,2,2,1,0
10407,"高雄市","旗山區中洲里",3,2,1,1,1,0,2,1
10407,"高雄市","旗山區竹峰里",1,1,0,3,2,1,1,1
10407,"高雄市","前金區北金里",0,0,0,1,0,1,0,1
10407,"高雄市","前金區博孝里",0,0,0,1,0,1,0,1
10407,"高雄市","前金區草江里",1,1,0,0,0,0,0,1
10407,"高雄市","前金區東金里",1,0,1,3,2,1,0,0
10407,"高雄市","前金區復元里",2,2,0,3,1,2,2,1
10407,"高雄市","前金區國民里",3,1,2,3,1,2,0,0
10407,"高雄市","前金區後金里",0,0,0,1,1,0,1,1
10407,"高雄市","前金區林投里",0,0,0,2,2,0,0,0
10407,"高雄市","前金區民生里",2,1,1,4,2,2,1,0
10407,"高雄市","前金區青山里",5,2,3,2,1,1,1,0
10407,"高雄市","前金區榮復里",1,1,0,0,0,0,1,0
10407,"高雄市","前金區三川里",1,1,0,3,0,3,1,0
10407,"高雄市","前金區社東里",1,1,0,4,2,2,1,1
10407,"高雄市","前金區社西里",1,1,0,1,1,0,0,0
10407,"高雄市","前金區文東里",1,0,1,6,2,4,0,0
10407,"高雄市","前金區文西里",2,1,1,2,2,0,1,1
10407,"高雄市","前金區新生里",7,5,2,9,4,5,1,1
10407,"高雄市","前金區長城里",2,0,2,1,0,1,0,0
10407,"高雄市","前金區長生里",0,0,0,1,1,0,0,0
10407,"高雄市","前金區長興里",0,0,0,1,1,0,1,1
10407,"高雄市","前鎮區草衙里",8,7,1,16,9,7,6,8
10407,"高雄市","前鎮區德昌里",2,1,1,4,2,2,1,3
10407,"高雄市","前鎮區復國里",2,1,1,5,2,3,1,2
10407,"高雄市","前鎮區建隆里",1,0,1,3,2,1,2,1
10407,"高雄市","前鎮區良和里",3,1,2,2,1,1,2,1
10407,"高雄市","前鎮區民權里",8,4,4,6,5,1,3,5
10407,"高雄市","前鎮區明道里",1,1,0,4,4,0,1,0
10407,"高雄市","前鎮區明禮里",1,1,0,3,3,0,1,0
10407,"高雄市","前鎮區明孝里",1,1,0,4,3,1,2,2
10407,"高雄市","前鎮區明義里",4,2,2,5,3,2,2,0
10407,"高雄市","前鎮區明正里",7,5,2,4,4,0,5,3
10407,"高雄市","前鎮區平昌里",0,0,0,2,2,0,0,1
10407,"高雄市","前鎮區平等里",1,1,0,6,4,2,2,5
10407,"高雄市","前鎮區前鎮里",2,1,1,3,2,1,0,1
10407,"高雄市","前鎮區仁愛里",1,1,0,3,3,0,0,0
10407,"高雄市","前鎮區瑞北里",5,4,1,3,1,2,3,1
10407,"高雄市","前鎮區瑞昌里",4,1,3,6,4,2,3,2
10407,"高雄市","前鎮區瑞誠里",4,2,2,3,3,0,2,3
10407,"高雄市","前鎮區瑞東里",3,3,0,5,3,2,3,3
10407,"高雄市","前鎮區瑞豐里",6,3,3,6,3,3,3,1
10407,"高雄市","前鎮區瑞崗里",6,5,1,4,3,1,3,1
10407,"高雄市","前鎮區瑞和里",2,1,1,4,3,1,2,0
10407,"高雄市","前鎮區瑞華里",8,5,3,5,3,2,2,3
10407,"高雄市","前鎮區瑞隆里",5,1,4,4,2,2,1,0
10407,"高雄市","前鎮區瑞南里",6,2,4,5,4,1,4,2
10407,"高雄市","前鎮區瑞平里",4,1,3,5,1,4,4,4
10407,"高雄市","前鎮區瑞文里",2,0,2,3,1,2,1,0
10407,"高雄市","前鎮區瑞西里",3,2,1,4,2,2,1,0
10407,"高雄市","前鎮區瑞祥里",11,7,4,6,1,5,4,2
10407,"高雄市","前鎮區瑞興里",5,3,2,3,3,0,0,1
10407,"高雄市","前鎮區瑞竹里",0,0,0,2,0,2,3,0
10407,"高雄市","前鎮區盛豐里",2,1,1,5,3,2,1,3
10407,"高雄市","前鎮區盛興里",4,2,2,5,3,2,3,2
10407,"高雄市","前鎮區西甲里",0,0,0,3,3,0,1,1
10407,"高雄市","前鎮區西山里",7,7,0,5,3,2,2,1
10407,"高雄市","前鎮區信德里",1,0,1,5,4,1,1,4
10407,"高雄市","前鎮區信義里",0,0,0,3,2,1,3,1
10407,"高雄市","前鎮區興邦里",3,1,2,1,1,0,0,2
10407,"高雄市","前鎮區興東里",9,5,4,7,2,5,5,2
10407,"高雄市","前鎮區興化里",1,0,1,2,2,0,0,0
10407,"高雄市","前鎮區興仁里",2,2,0,3,3,0,0,0
10407,"高雄市","前鎮區興中里",5,1,4,6,5,1,7,1
10407,"高雄市","前鎮區振興里",7,3,4,0,0,0,2,0
10407,"高雄市","前鎮區鎮北里",1,0,1,2,1,1,0,0
10407,"高雄市","前鎮區鎮昌里",3,1,2,4,3,1,2,2
10407,"高雄市","前鎮區鎮東里",4,3,1,5,3,2,0,1
10407,"高雄市","前鎮區鎮海里",6,5,1,6,5,1,2,1
10407,"高雄市","前鎮區鎮榮里",3,1,2,3,3,0,2,0
10407,"高雄市","前鎮區鎮陽里",1,1,0,3,1,2,1,0
10407,"高雄市","前鎮區鎮中里",1,1,0,0,0,0,0,0
10407,"高雄市","前鎮區忠誠里",4,2,2,3,0,3,1,0
10407,"高雄市","前鎮區忠純里",6,3,3,12,9,3,2,2
10407,"高雄市","前鎮區忠孝里",1,0,1,2,0,2,3,1
10407,"高雄市","前鎮區竹北里",2,1,1,1,1,0,1,0
10407,"高雄市","前鎮區竹東里",3,2,1,6,3,3,1,1
10407,"高雄市","前鎮區竹南里",9,3,6,11,6,5,4,4
10407,"高雄市","前鎮區竹內里",3,1,2,4,1,3,4,0
10407,"高雄市","前鎮區竹西里",12,4,8,4,2,2,3,1
10407,"高雄市","前鎮區竹中里",7,2,5,1,1,0,2,3
10407,"高雄市","橋頭區白樹里",4,2,2,5,2,3,2,2
10407,"高雄市","橋頭區筆秀里",4,1,3,4,2,2,1,4
10407,"高雄市","橋頭區德松里",2,1,1,5,2,3,1,2
10407,"高雄市","橋頭區頂鹽里",0,0,0,1,1,0,2,0
10407,"高雄市","橋頭區東林里",4,2,2,5,2,3,2,2
10407,"高雄市","橋頭區甲北里",4,1,3,4,2,2,0,1
10407,"高雄市","橋頭區甲南里",5,2,3,5,3,2,5,1
10407,"高雄市","橋頭區橋南里",1,1,0,1,1,0,0,1
10407,"高雄市","橋頭區橋頭里",1,0,1,2,1,1,0,1
10407,"高雄市","橋頭區三德里",0,0,0,0,0,0,0,1
10407,"高雄市","橋頭區仕豐里",3,2,1,2,1,1,2,0
10407,"高雄市","橋頭區仕和里",9,6,3,4,2,2,1,4
10407,"高雄市","橋頭區仕隆里",3,1,2,4,3,1,1,0
10407,"高雄市","橋頭區西林里",1,0,1,3,2,1,0,0
10407,"高雄市","橋頭區新莊里",8,3,5,5,1,4,0,2
10407,"高雄市","橋頭區芋寮里",1,1,0,3,3,0,0,0
10407,"高雄市","橋頭區中崎里",0,0,0,0,0,0,2,1
10407,"高雄市","仁武區八卦里",28,12,16,9,5,4,14,9
10407,"高雄市","仁武區赤山里",13,6,7,5,2,3,6,3
10407,"高雄市","仁武區大灣里",8,1,7,2,1,1,3,1
10407,"高雄市","仁武區高楠里",1,0,1,8,4,4,1,2
10407,"高雄市","仁武區後安里",4,1,3,0,0,0,1,1
10407,"高雄市","仁武區考潭里",0,0,0,7,5,2,3,3
10407,"高雄市","仁武區仁慈里",3,1,2,4,3,1,3,1
10407,"高雄市","仁武區仁福里",2,0,2,1,1,0,0,0
10407,"高雄市","仁武區仁和里",8,4,4,4,2,2,7,4
10407,"高雄市","仁武區仁武里",9,8,1,7,4,3,7,1
10407,"高雄市","仁武區灣內里",9,4,5,6,3,3,9,1
10407,"高雄市","仁武區文武里",10,6,4,18,13,5,9,3
10407,"高雄市","仁武區烏林里",9,5,4,10,6,4,1,2
10407,"高雄市","仁武區五和里",9,4,5,5,4,1,5,1
10407,"高雄市","仁武區中華里",2,2,0,7,4,3,1,1
10407,"高雄市","仁武區竹後里",5,3,2,4,3,1,2,0
10407,"高雄市","三民區安邦里",10,4,6,4,2,2,4,2
10407,"高雄市","三民區安東里",5,0,5,4,2,2,2,0
10407,"高雄市","三民區安發里",4,2,2,4,2,2,4,7
10407,"高雄市","三民區安和里",2,1,1,6,4,2,2,1
10407,"高雄市","三民區安吉里",4,2,2,7,4,3,7,3
10407,"高雄市","三民區安康里",5,5,0,9,7,2,1,1
10407,"高雄市","三民區安寧里",1,0,1,6,2,4,3,0
10407,"高雄市","三民區安生里",1,1,0,4,2,2,2,0
10407,"高雄市","三民區安泰里",7,5,2,7,5,2,5,5
10407,"高雄市","三民區安宜里",9,8,1,4,2,2,5,3
10407,"高雄市","三民區寶安里",9,6,3,5,4,1,6,3
10407,"高雄市","三民區寶德里",9,3,6,4,2,2,7,1
10407,"高雄市","三民區寶國里",16,10,6,5,4,1,4,4
10407,"高雄市","三民區寶華里",8,5,3,1,0,1,2,3
10407,"高雄市","三民區寶龍里",4,2,2,7,6,1,5,2
10407,"高雄市","三民區寶民里",4,3,1,4,2,2,2,1
10407,"高雄市","三民區寶慶里",3,3,0,0,0,0,4,0
10407,"高雄市","三民區寶盛里",6,2,4,7,4,3,9,2
10407,"高雄市","三民區寶獅里",6,2,4,3,1,2,8,1
10407,"高雄市","三民區寶泰里",9,5,4,0,0,0,3,1
10407,"高雄市","三民區寶興里",13,9,4,13,6,7,5,2
10407,"高雄市","三民區寶業里",8,2,6,4,2,2,0,0
10407,"高雄市","三民區寶玉里",11,3,8,7,3,4,7,7
10407,"高雄市","三民區寶中里",4,3,1,5,3,2,1,0
10407,"高雄市","三民區寶珠里",6,4,2,7,3,4,7,1
10407,"高雄市","三民區本安里",9,5,4,5,4,1,6,2
10407,"高雄市","三民區本館里",11,7,4,10,3,7,18,4
10407,"高雄市","三民區本和里",7,5,2,7,3,4,5,4
10407,"高雄市","三民區本上里",7,3,4,4,2,2,4,0
10407,"高雄市","三民區本文里",1,0,1,4,0,4,3,2
10407,"高雄市","三民區本武里",2,2,0,0,0,0,1,0
10407,"高雄市","三民區本揚里",9,6,3,5,3,2,8,2
10407,"高雄市","三民區本元里",5,2,3,5,2,3,4,3
10407,"高雄市","三民區博愛里",2,1,1,3,0,3,2,0
10407,"高雄市","三民區博惠里",7,3,4,4,4,0,5,2
10407,"高雄市","三民區川東里",3,3,0,2,1,1,3,0
10407,"高雄市","三民區達德里",3,1,2,2,1,1,2,0
10407,"高雄市","三民區達明里",1,1,0,3,2,1,0,1
10407,"高雄市","三民區達仁里",2,2,0,0,0,0,1,0
10407,"高雄市","三民區達勇里",0,0,0,1,1,0,0,0
10407,"高雄市","三民區德北里",2,1,1,2,2,0,0,0
10407,"高雄市","三民區德東里",0,0,0,1,0,1,0,0
10407,"高雄市","三民區德仁里",1,1,0,3,2,1,5,0
10407,"高雄市","三民區德西里",0,0,0,2,1,1,1,1
10407,"高雄市","三民區德行里",0,0,0,3,1,2,1,0
10407,"高雄市","三民區德智里",4,3,1,2,1,1,1,0
10407,"高雄市","三民區鼎金里",13,9,4,9,7,2,6,2
10407,"高雄市","三民區鼎力里",5,4,1,3,2,1,1,1
10407,"高雄市","三民區鼎強里",9,4,5,4,2,2,5,3
10407,"高雄市","三民區鼎盛里",9,3,6,6,3,3,7,4
10407,"高雄市","三民區鼎泰里",30,15,15,10,6,4,17,9
10407,"高雄市","三民區鼎西里",10,7,3,8,6,2,8,1
10407,"高雄市","三民區鼎中里",7,1,6,1,1,0,1,1
10407,"高雄市","三民區豐裕里",4,1,3,9,2,7,1,2
10407,"高雄市","三民區鳳北里",5,2,3,1,0,1,1,0
10407,"高雄市","三民區鳳南里",0,0,0,4,2,2,1,2
10407,"高雄市","三民區港東里",2,1,1,4,2,2,2,0
10407,"高雄市","三民區港西里",0,0,0,2,1,1,0,1
10407,"高雄市","三民區港新里",1,0,1,2,1,1,2,1
10407,"高雄市","三民區建東里",2,2,0,2,2,0,3,2
10407,"高雄市","三民區精華里",1,0,1,6,3,3,0,1
10407,"高雄市","三民區力行里",1,1,0,1,1,0,0,0
10407,"高雄市","三民區立誠里",1,1,0,2,0,2,1,1
10407,"高雄市","三民區立德里",0,0,0,2,1,1,1,2
10407,"高雄市","三民區立業里",0,0,0,3,3,0,2,2
10407,"高雄市","三民區民享里",0,0,0,2,0,2,2,1
10407,"高雄市","三民區千北里",1,0,1,4,2,2,3,0
10407,"高雄市","三民區千秋里",2,0,2,2,1,1,1,0
10407,"高雄市","三民區千歲里",3,1,2,0,0,0,0,1
10407,"高雄市","三民區十美里",4,2,2,2,0,2,1,1
10407,"高雄市","三民區十全里",1,0,1,3,1,2,1,1
10407,"高雄市","三民區同德里",3,2,1,2,1,1,0,0
10407,"高雄市","三民區灣愛里",5,3,2,5,3,2,3,2
10407,"高雄市","三民區灣成里",2,0,2,3,3,0,2,1
10407,"高雄市","三民區灣復里",10,4,6,7,4,3,5,2
10407,"高雄市","三民區灣華里",1,0,1,0,0,0,3,2
10407,"高雄市","三民區灣利里",3,2,1,5,1,4,1,2
10407,"高雄市","三民區灣勝里",3,2,1,4,4,0,0,1
10407,"高雄市","三民區灣興里",3,0,3,2,0,2,0,2
10407,"高雄市","三民區灣中里",12,7,5,3,3,0,9,5
10407,"高雄市","三民區灣子里",8,4,4,7,4,3,2,1
10407,"高雄市","三民區興德里",0,0,0,6,3,3,2,0
10407,"高雄市","三民區裕民里",3,2,1,1,1,0,1,1
10407,"高雄市","三民區長明里",3,0,3,1,1,0,1,0
10407,"高雄市","三民區正順里",6,4,2,4,2,2,4,2
10407,"高雄市","三民區正興里",18,12,6,10,6,4,7,3
10407,"高雄市","杉林區大愛里",4,2,2,4,4,0,4,0
10407,"高雄市","杉林區集來里",1,1,0,2,2,0,1,0
10407,"高雄市","杉林區木梓里",1,1,0,2,1,1,0,2
10407,"高雄市","杉林區杉林里",0,0,0,1,1,0,1,1
10407,"高雄市","杉林區上平里",2,1,1,3,2,1,0,0
10407,"高雄市","杉林區新庄里",1,1,0,4,2,2,0,0
10407,"高雄市","杉林區月眉里",3,2,1,4,2,2,2,1
10407,"高雄市","杉林區月美里",1,1,0,4,4,0,1,0
10407,"高雄市","桃源區寶山里",1,1,0,2,2,0,1,0
10407,"高雄市","桃源區復興里",1,0,1,0,0,0,1,0
10407,"高雄市","桃源區高中里",1,0,1,5,5,0,1,0
10407,"高雄市","桃源區建山里",2,2,0,0,0,0,2,0
10407,"高雄市","桃源區拉芙蘭里",0,0,0,0,0,0,0,1
10407,"高雄市","桃源區梅山里",1,1,0,0,0,0,0,0
10407,"高雄市","桃源區勤和里",1,0,1,0,0,0,1,0
10407,"高雄市","桃源區桃源里",4,4,0,3,3,0,0,0
10407,"高雄市","田寮區崇德里",1,0,1,4,1,3,1,0
10407,"高雄市","田寮區大同里",0,0,0,2,2,0,0,0
10407,"高雄市","田寮區古亭里",0,0,0,0,0,0,0,1
10407,"高雄市","田寮區鹿埔里",0,0,0,2,2,0,0,0
10407,"高雄市","田寮區南安里",0,0,0,0,0,0,0,1
10407,"高雄市","田寮區七星里",0,0,0,0,0,0,0,1
10407,"高雄市","田寮區三和里",0,0,0,1,0,1,0,1
10407,"高雄市","田寮區田寮里",0,0,0,1,1,0,0,0
10407,"高雄市","田寮區西德里",0,0,0,1,1,0,1,0
10407,"高雄市","田寮區新興里",0,0,0,2,2,0,1,1
10407,"高雄市","小港區大苓里",7,4,3,6,2,4,2,0
10407,"高雄市","小港區大坪里",4,2,2,2,0,2,1,1
10407,"高雄市","小港區店鎮里",8,5,3,6,4,2,2,4
10407,"高雄市","小港區二苓里",8,5,3,2,1,1,2,1
10407,"高雄市","小港區鳳宮里",6,1,5,2,1,1,0,3
10407,"高雄市","小港區鳳林里",7,2,5,4,4,0,2,0
10407,"高雄市","小港區鳳鳴里",4,3,1,10,3,7,2,2
10407,"高雄市","小港區鳳森里",2,1,1,1,1,0,4,0
10407,"高雄市","小港區鳳興里",6,2,4,4,1,3,2,1
10407,"高雄市","小港區鳳源里",3,2,1,9,7,2,5,4
10407,"高雄市","小港區港后里",2,1,1,1,1,0,0,3
10407,"高雄市","小港區港口里",5,4,1,6,5,1,0,1
10407,"高雄市","小港區港明里",3,1,2,3,1,2,2,0
10407,"高雄市","小港區港南里",5,3,2,2,1,1,1,0
10407,"高雄市","小港區港墘里",2,1,1,5,3,2,2,2
10407,"高雄市","小港區港興里",2,2,0,5,5,0,0,1
10407,"高雄市","小港區港正里",4,3,1,4,3,1,6,1
10407,"高雄市","小港區高松里",11,7,4,6,5,1,2,0
10407,"高雄市","小港區桂林里",16,11,5,11,7,4,4,6
10407,"高雄市","小港區合作里",4,4,0,2,2,0,3,0
10407,"高雄市","小港區宏亮里",5,3,2,2,1,1,3,2
10407,"高雄市","小港區濟南里",2,1,1,6,4,2,3,3
10407,"高雄市","小港區孔宅里",7,6,1,4,3,1,5,2
10407,"高雄市","小港區六苓里",5,4,1,3,1,2,0,3
10407,"高雄市","小港區龍鳳里",6,4,2,2,1,1,2,0
10407,"高雄市","小港區坪頂里",15,11,4,3,0,3,8,4
10407,"高雄市","小港區青島里",3,2,1,6,3,3,0,1
10407,"高雄市","小港區三苓里",6,2,4,1,1,0,5,4
10407,"高雄市","小港區廈莊里",10,6,4,4,3,1,3,1
10407,"高雄市","小港區山東里",6,4,2,3,3,0,1,2
10407,"高雄市","小港區山明里",23,12,11,7,3,4,19,3
10407,"高雄市","小港區順苓里",8,5,3,4,1,3,6,4
10407,"高雄市","小港區松金里",2,1,1,5,2,3,2,1
10407,"高雄市","小港區松山里",7,2,5,4,1,3,3,1
10407,"高雄市","小港區泰山里",3,2,1,3,3,0,5,1
10407,"高雄市","小港區小港里",1,1,0,1,1,0,1,4
10407,"高雄市","小港區正苓里",10,5,5,1,1,0,4,0
10407,"高雄市","小港區中厝里",10,6,4,4,2,2,2,1
10407,"高雄市","新興區愛平里",1,1,0,1,0,1,2,0
10407,"高雄市","新興區成功里",0,0,0,2,0,2,2,0
10407,"高雄市","新興區大明里",2,1,1,1,1,0,0,0
10407,"高雄市","新興區德生里",4,1,3,3,2,1,0,1
10407,"高雄市","新興區德望里",4,3,1,3,2,1,1,0
10407,"高雄市","新興區德政里",0,0,0,2,2,0,0,0
10407,"高雄市","新興區東坡里",2,1,1,1,1,0,2,0
10407,"高雄市","新興區光耀里",2,1,1,3,2,1,0,0
10407,"高雄市","新興區漢民里",0,0,0,0,0,0,2,0
10407,"高雄市","新興區浩然里",2,2,0,2,2,0,0,1
10407,"高雄市","新興區華聲里",2,1,1,1,0,1,2,0
10407,"高雄市","新興區建華里",0,0,0,2,2,0,0,0
10407,"高雄市","新興區建興里",1,0,1,4,4,0,1,0
10407,"高雄市","新興區蕉園里",2,1,1,2,1,1,1,0
10407,"高雄市","新興區開平里",9,4,5,5,3,2,3,2
10407,"高雄市","新興區黎明里",1,1,0,1,1,0,0,0
10407,"高雄市","新興區明莊里",0,0,0,1,0,1,0,1
10407,"高雄市","新興區南港里",5,4,1,2,1,1,1,1
10407,"高雄市","新興區秋山里",0,0,0,1,1,0,1,0
10407,"高雄市","新興區仁聲里",3,2,1,1,1,0,3,0
10407,"高雄市","新興區榮治里",1,1,0,3,3,0,0,0
10407,"高雄市","新興區順昌里",3,1,2,2,1,1,0,0
10407,"高雄市","新興區文昌里",2,2,0,1,1,0,3,0
10407,"高雄市","新興區新江里",2,1,1,2,0,2,0,1
10407,"高雄市","新興區興昌里",2,1,1,3,1,2,1,0
10407,"高雄市","新興區永寧里",0,0,0,1,1,0,1,0
10407,"高雄市","新興區玉衡里",1,0,1,2,1,1,0,0
10407,"高雄市","新興區長驛里",0,0,0,1,0,1,0,1
10407,"高雄市","新興區振成里",2,2,0,2,2,0,0,0
10407,"高雄市","新興區振華里",1,0,1,3,2,1,1,0
10407,"高雄市","新興區正氣里",0,0,0,1,1,0,3,1
10407,"高雄市","新興區中東里",1,1,0,7,5,2,6,2
10407,"高雄市","鹽埕區博愛里",0,0,0,1,1,0,0,0
10407,"高雄市","鹽埕區慈愛里",0,0,0,2,1,1,0,0
10407,"高雄市","鹽埕區府北里",3,1,2,4,2,2,0,3
10407,"高雄市","鹽埕區港都里",1,1,0,0,0,0,0,1
10407,"高雄市","鹽埕區光明里",0,0,0,4,3,1,2,1
10407,"高雄市","鹽埕區河濱里",1,1,0,2,1,1,0,0
10407,"高雄市","鹽埕區江南里",1,0,1,0,0,0,0,1
10407,"高雄市","鹽埕區江西里",5,3,2,2,0,2,1,1
10407,"高雄市","鹽埕區教仁里",4,1,3,4,1,3,3,3
10407,"高雄市","鹽埕區瀨南里",0,0,0,1,0,1,0,0
10407,"高雄市","鹽埕區藍橋里",2,1,1,4,4,0,1,2
10407,"高雄市","鹽埕區陸橋里",1,0,1,1,1,0,1,1
10407,"高雄市","鹽埕區南端里",0,0,0,0,0,0,0,1
10407,"高雄市","鹽埕區沙地里",0,0,0,2,1,1,1,0
10407,"高雄市","鹽埕區壽星里",3,2,1,5,3,2,0,0
10407,"高雄市","鹽埕區新豐里",3,1,2,2,2,0,1,0
10407,"高雄市","鹽埕區新化里",1,1,0,1,1,0,2,1
10407,"高雄市","鹽埕區新樂里",0,0,0,0,0,0,1,1
10407,"高雄市","鹽埕區育仁里",3,2,1,2,2,0,1,0
10407,"高雄市","鹽埕區中山里",1,0,1,1,0,1,2,0
10407,"高雄市","鹽埕區中原里",1,1,0,1,1,0,0,0
10407,"高雄市","燕巢區安招里",4,1,3,19,17,2,0,2
10407,"高雄市","燕巢區東燕里",1,0,1,3,2,1,1,3
10407,"高雄市","燕巢區鳳雄里",4,2,2,3,1,2,2,1
10407,"高雄市","燕巢區橫山里",2,1,1,6,4,2,1,2
10407,"高雄市","燕巢區尖山里",2,1,1,2,2,0,2,0
10407,"高雄市","燕巢區角宿里",2,1,1,3,1,2,1,1
10407,"高雄市","燕巢區金山里",1,0,1,1,0,1,0,0
10407,"高雄市","燕巢區南燕里",6,3,3,5,4,1,1,4
10407,"高雄市","燕巢區瓊林里",3,3,0,2,2,0,1,1
10407,"高雄市","燕巢區深水里",6,1,5,9,8,1,1,1
10407,"高雄市","燕巢區西燕里",6,4,2,4,2,2,3,3
10407,"高雄市","永安區保寧里",3,2,1,5,3,2,1,2
10407,"高雄市","永安區維新里",5,2,3,6,3,3,4,2
10407,"高雄市","永安區新港里",5,1,4,7,7,0,1,1
10407,"高雄市","永安區鹽田里",0,0,0,2,2,0,0,0
10407,"高雄市","永安區永安里",8,7,1,0,0,0,4,0
10407,"高雄市","永安區永華里",2,1,1,3,2,1,0,0
10407,"高雄市","梓官區赤東里",1,0,1,1,1,0,1,0
10407,"高雄市","梓官區赤崁里",2,1,1,3,2,1,2,1
10407,"高雄市","梓官區赤西里",1,1,0,1,1,0,1,0
10407,"高雄市","梓官區大舍里",9,1,8,4,2,2,4,0
10407,"高雄市","梓官區典寶里",5,4,1,2,1,1,4,1
10407,"高雄市","梓官區茄苳里",5,3,2,2,0,2,4,0
10407,"高雄市","梓官區禮蚵里",1,1,0,5,2,3,0,1
10407,"高雄市","梓官區同安里",1,1,0,1,1,0,1,1
10407,"高雄市","梓官區信蚵里",2,1,1,2,1,1,5,3
10407,"高雄市","梓官區智蚵里",4,3,1,3,1,2,1,1
10407,"高雄市","梓官區中崙里",1,1,0,0,0,0,1,0
10407,"高雄市","梓官區梓和里",5,4,1,3,2,1,2,1
10407,"高雄市","梓官區梓平里",3,2,1,2,2,0,3,1
10407,"高雄市","梓官區梓信里",3,3,0,2,1,1,0,3
10407,"高雄市","梓官區梓義里",2,0,2,10,6,4,2,0
10407,"高雄市","左營區菜公里",49,24,25,25,14,11,19,8
10407,"高雄市","左營區城南里",1,1,0,1,1,0,0,1
10407,"高雄市","左營區崇實里",20,8,12,3,2,1,6,3
10407,"高雄市","左營區頂北里",0,0,0,1,0,1,0,1
10407,"高雄市","左營區頂西里",1,1,0,2,1,1,0,1
10407,"高雄市","左營區福山里",62,34,28,21,13,8,30,20
10407,"高雄市","左營區光輝里",2,2,0,3,3,0,0,0
10407,"高雄市","左營區果峰里",2,1,1,6,4,2,0,0
10407,"高雄市","左營區果惠里",3,1,2,1,1,0,1,0
10407,"高雄市","左營區果貿里",3,0,3,3,3,0,4,2
10407,"高雄市","左營區海勝里",6,3,3,12,8,4,4,3
10407,"高雄市","左營區合群里",2,2,0,13,11,2,2,4
10407,"高雄市","左營區進學里",1,1,0,9,7,2,2,1
10407,"高雄市","左營區莒光里",2,2,0,1,1,0,4,1
10407,"高雄市","左營區路東里",2,2,0,0,0,0,1,0
10407,"高雄市","左營區廟北里",0,0,0,2,1,1,0,0
10407,"高雄市","左營區廟東里",1,1,0,2,2,0,2,0
10407,"高雄市","左營區明建里",5,5,0,3,1,2,2,1
10407,"高雄市","左營區埤北里",2,1,1,3,2,1,1,1
10407,"高雄市","左營區埤東里",1,0,1,5,2,3,2,0
10407,"高雄市","左營區埤西里",0,0,0,0,0,0,2,2
10407,"高雄市","左營區屏山里",2,1,1,5,4,1,1,0
10407,"高雄市","左營區廍北里",0,0,0,0,0,0,0,0
10407,"高雄市","左營區廍南里",2,2,0,2,2,0,0,0
10407,"高雄市","左營區聖后里",0,0,0,2,2,0,0,1
10407,"高雄市","左營區聖南里",0,0,0,0,0,0,1,1
10407,"高雄市","左營區聖西里",0,0,0,2,1,1,0,1
10407,"高雄市","左營區尾北里",5,2,3,8,4,4,5,1
10407,"高雄市","左營區尾南里",0,0,0,1,1,0,1,0
10407,"高雄市","左營區尾西里",0,0,0,3,1,2,2,0
10407,"高雄市","左營區祥和里",0,0,0,1,1,0,0,0
10407,"高雄市","左營區新光里",18,7,11,12,6,6,7,4
10407,"高雄市","左營區新上里",35,21,14,19,11,8,23,8
10407,"高雄市","左營區新下里",16,6,10,18,9,9,9,6
10407,"高雄市","左營區新中里",6,2,4,6,4,2,2,0
10407,"高雄市","左營區永清里",4,2,2,6,6,0,1,2
10407,"高雄市","左營區中北里",0,0,0,0,0,0,0,0
10407,"高雄市","左營區中南里",0,0,0,3,2,1,0,0
10407,"高雄市","左營區自助里",0,0,0,1,1,0,0,0
10409,"高雄市","阿蓮區阿蓮里",14,8,6,9,6,3,8,1
10409,"高雄市","阿蓮區峯山里",3,1,2,2,2,0,1,0
10409,"高雄市","阿蓮區復安里",0,0,0,2,2,0,1,1
10409,"高雄市","阿蓮區崗山里",1,1,0,2,0,2,1,1
10409,"高雄市","阿蓮區港後里",5,3,2,1,0,1,1,1
10409,"高雄市","阿蓮區和蓮里",1,0,1,3,2,1,2,1
10409,"高雄市","阿蓮區南蓮里",10,6,4,3,3,0,2,0
10409,"高雄市","阿蓮區青旗里",1,0,1,4,2,2,2,0
10409,"高雄市","阿蓮區清蓮里",5,4,1,5,3,2,2,0
10409,"高雄市","阿蓮區石安里",2,2,0,5,4,1,2,0
10409,"高雄市","阿蓮區玉庫里",2,2,0,3,2,1,1,0
10409,"高雄市","阿蓮區中路里",2,1,1,2,2,0,1,1
10409,"高雄市","大寮區潮寮里",2,2,0,5,2,3,2,0
10409,"高雄市","大寮區大寮里",12,8,4,12,8,4,5,0
10409,"高雄市","大寮區光武里",0,0,0,0,0,0,0,0
10409,"高雄市","大寮區過溪里",4,1,3,2,2,0,4,2
10409,"高雄市","大寮區後庄里",8,2,6,6,3,3,7,1
10409,"高雄市","大寮區會結里",3,1,2,4,3,1,0,3
10409,"高雄市","大寮區會社里",5,3,2,8,7,1,4,0
10409,"高雄市","大寮區江山里",1,1,0,2,2,0,1,3
10409,"高雄市","大寮區拷潭里",5,3,2,1,1,0,1,1
10409,"高雄市","大寮區琉球里",10,7,3,9,3,6,11,2
10409,"高雄市","大寮區內坑里",13,8,5,9,7,2,6,6
10409,"高雄市","大寮區前庄里",5,4,1,3,2,1,5,2
10409,"高雄市","大寮區三隆里",6,3,3,9,6,3,5,4
10409,"高雄市","大寮區山頂里",14,3,11,12,8,4,10,4
10409,"高雄市","大寮區上寮里",7,3,4,3,2,1,1,1
10409,"高雄市","大寮區翁園里",14,6,8,5,3,2,5,2
10409,"高雄市","大寮區溪寮里",2,0,2,1,1,0,1,0
10409,"高雄市","大寮區新厝里",4,2,2,4,2,2,3,1
10409,"高雄市","大寮區義和里",8,6,2,2,1,1,2,0
10409,"高雄市","大寮區義仁里",1,1,0,2,1,1,3,0
10409,"高雄市","大寮區永芳里",4,2,2,7,7,0,6,5
10409,"高雄市","大寮區昭明里",6,4,2,7,5,2,7,0
10409,"高雄市","大寮區中興里",9,5,4,8,6,2,10,1
10409,"高雄市","大寮區中庄里",21,13,8,13,11,2,14,2
10409,"高雄市","大寮區忠義里",2,0,2,1,1,0,2,0
10409,"高雄市","大社區保安里",6,3,3,4,1,3,4,1
10409,"高雄市","大社區保社里",3,1,2,2,1,1,8,2
10409,"高雄市","大社區翠屏里",3,2,1,2,2,0,3,1
10409,"高雄市","大社區大社里",8,6,2,7,6,1,8,2
10409,"高雄市","大社區觀音里",6,5,1,5,4,1,11,2
10409,"高雄市","大社區嘉誠里",1,0,1,6,3,3,1,1
10409,"高雄市","大社區三奶里",3,2,1,0,0,0,5,0
10409,"高雄市","大社區神農里",12,6,6,6,3,3,6,2
10409,"高雄市","大社區中里里",6,2,4,8,5,3,5,0
10409,"高雄市","大樹區大坑里",5,2,3,2,1,1,1,0
10409,"高雄市","大樹區大樹里",5,3,2,3,2,1,2,0
10409,"高雄市","大樹區姑山里",3,2,1,3,2,1,2,1
10409,"高雄市","大樹區和山里",1,1,0,1,1,0,1,3
10409,"高雄市","大樹區井腳里",1,1,0,4,3,1,0,0
10409,"高雄市","大樹區九曲里",13,9,4,7,3,4,4,2
10409,"高雄市","大樹區久堂里",5,5,0,3,3,0,2,0
10409,"高雄市","大樹區龍目里",4,3,1,5,2,3,1,0
10409,"高雄市","大樹區三和里",0,0,0,1,0,1,2,1
10409,"高雄市","大樹區檨腳里",6,1,5,5,3,2,3,2
10409,"高雄市","大樹區水安里",3,2,1,8,5,3,1,0
10409,"高雄市","大樹區水寮里",2,1,1,4,3,1,0,2
10409,"高雄市","大樹區統嶺里",1,1,0,2,2,0,1,0
10409,"高雄市","大樹區溪埔里",1,1,0,5,2,3,0,2
10409,"高雄市","大樹區小坪里",1,1,0,0,0,0,2,0
10409,"高雄市","大樹區興山里",6,2,4,2,1,1,0,0
10409,"高雄市","大樹區興田里",5,3,2,0,0,0,0,1
10409,"高雄市","大樹區竹寮里",6,5,1,2,0,2,2,0
10409,"高雄市","鳳山區保安里",20,11,9,3,2,1,9,3
10409,"高雄市","鳳山區北門里",11,6,5,8,3,5,2,0
10409,"高雄市","鳳山區曹公里",2,0,2,0,0,0,2,2
10409,"高雄市","鳳山區成功里",0,0,0,1,0,1,0,0
10409,"高雄市","鳳山區誠德里",3,2,1,3,1,2,2,2
10409,"高雄市","鳳山區誠信里",2,2,0,1,0,1,2,3
10409,"高雄市","鳳山區誠義里",15,6,9,3,2,1,5,3
10409,"高雄市","鳳山區誠智里",5,4,1,3,2,1,3,2
10409,"高雄市","鳳山區大德里",12,9,3,8,7,1,6,1
10409,"高雄市","鳳山區東門里",11,5,6,13,6,7,12,3
10409,"高雄市","鳳山區二甲里",9,4,5,6,5,1,4,0
10409,"高雄市","鳳山區鳳東里",10,4,6,4,4,0,5,6
10409,"高雄市","鳳山區鳳崗里",4,3,1,3,2,1,0,1
10409,"高雄市","鳳山區福誠里",5,0,5,1,1,0,5,1
10409,"高雄市","鳳山區福祥里",3,2,1,6,4,2,4,1
10409,"高雄市","鳳山區福興里",13,11,2,10,7,3,6,3
10409,"高雄市","鳳山區富甲里",1,0,1,3,1,2,1,0
10409,"高雄市","鳳山區富榮里",7,3,4,2,1,1,2,0
10409,"高雄市","鳳山區光明里",1,1,0,2,2,0,2,0
10409,"高雄市","鳳山區國富里",7,2,5,0,0,0,4,1
10409,"高雄市","鳳山區國光里",6,4,2,7,4,3,3,2
10409,"高雄市","鳳山區國隆里",4,2,2,2,0,2,1,1
10409,"高雄市","鳳山區國泰里",8,1,7,3,2,1,6,2
10409,"高雄市","鳳山區過埤里",40,14,26,6,3,3,21,8
10409,"高雄市","鳳山區海光里",3,1,2,4,2,2,3,1
10409,"高雄市","鳳山區海洋里",3,2,1,4,2,2,5,4
10409,"高雄市","鳳山區和德里",5,1,4,2,2,0,1,2
10409,"高雄市","鳳山區和興里",10,3,7,6,1,5,5,3
10409,"高雄市","鳳山區老爺里",19,13,6,8,5,3,9,4
10409,"高雄市","鳳山區龍成里",3,3,0,3,2,1,5,4
10409,"高雄市","鳳山區南成里",27,13,14,4,2,2,7,6
10409,"高雄市","鳳山區南和里",2,1,1,5,5,0,1,1
10409,"高雄市","鳳山區南興里",3,0,3,6,2,4,1,1
10409,"高雄市","鳳山區埤頂里",9,5,4,3,1,2,14,6
10409,"高雄市","鳳山區瑞興里",9,7,2,5,5,0,6,1
10409,"高雄市","鳳山區瑞竹里",13,7,6,9,7,2,4,1
10409,"高雄市","鳳山區三民里",1,1,0,4,2,2,2,1
10409,"高雄市","鳳山區善美里",8,8,0,2,1,1,7,8
10409,"高雄市","鳳山區生明里",4,3,1,4,4,0,0,2
10409,"高雄市","鳳山區天興里",6,2,4,2,1,1,7,3
10409,"高雄市","鳳山區文德里",16,9,7,6,2,4,12,1
10409,"高雄市","鳳山區文福里",27,12,15,10,4,6,19,3
10409,"高雄市","鳳山區文衡里",7,3,4,7,4,3,6,3
10409,"高雄市","鳳山區文華里",17,8,9,12,9,3,9,2
10409,"高雄市","鳳山區文山里",15,6,9,7,1,6,6,7
10409,"高雄市","鳳山區文英里",5,3,2,3,3,0,0,1
10409,"高雄市","鳳山區五福里",6,2,4,4,2,2,1,0
10409,"高雄市","鳳山區武漢里",5,2,3,9,5,4,5,6
10409,"高雄市","鳳山區武慶里",7,2,5,3,2,1,3,1
10409,"高雄市","鳳山區武松里",5,0,5,3,3,0,2,2
10409,"高雄市","鳳山區縣口里",0,0,0,1,1,0,0,0
10409,"高雄市","鳳山區縣衙里",3,2,1,1,0,1,0,0
10409,"高雄市","鳳山區協和里",4,1,3,3,2,1,4,1
10409,"高雄市","鳳山區新富里",9,4,5,4,4,0,5,1
10409,"高雄市","鳳山區新甲里",6,3,3,1,0,1,4,4
10409,"高雄市","鳳山區新樂里",5,0,5,3,3,0,3,4
10409,"高雄市","鳳山區新強里",9,5,4,2,1,1,3,3
10409,"高雄市","鳳山區新泰里",11,7,4,5,2,3,3,6
10409,"高雄市","鳳山區新武里",3,1,2,2,1,1,2,0
10409,"高雄市","鳳山區新興里",3,1,2,3,2,1,3,0
10409,"高雄市","鳳山區興仁里",10,5,5,3,3,0,3,1
10409,"高雄市","鳳山區興中里",2,1,1,2,2,0,1,1
10409,"高雄市","鳳山區一甲里",6,2,4,4,1,3,4,3
10409,"高雄市","鳳山區鎮北里",18,8,10,6,4,2,13,3
10409,"高雄市","鳳山區鎮東里",2,2,0,6,3,3,3,0
10409,"高雄市","鳳山區鎮南里",7,5,2,5,2,3,7,3
10409,"高雄市","鳳山區鎮西里",11,7,4,7,4,3,10,5
10409,"高雄市","鳳山區正義里",10,3,7,8,5,3,9,2
10409,"高雄市","鳳山區中和里",9,5,4,2,1,1,2,0
10409,"高雄市","鳳山區中崙里",5,1,4,1,1,0,4,0
10409,"高雄市","鳳山區中民里",10,6,4,1,0,1,3,3
10409,"高雄市","鳳山區中榮里",6,3,3,7,2,5,5,4
10409,"高雄市","鳳山區中正里",2,0,2,9,5,4,3,1
10409,"高雄市","鳳山區忠誠里",10,7,3,2,0,2,4,1
10409,"高雄市","鳳山區忠孝里",8,2,6,10,9,1,7,3
10409,"高雄市","鳳山區忠義里",9,3,6,9,8,1,5,4
10409,"高雄市","岡山區白米里",6,4,2,3,2,1,3,0
10409,"高雄市","岡山區本洲里",3,1,2,3,3,0,3,0
10409,"高雄市","岡山區碧紅里",8,4,4,1,1,0,3,2
10409,"高雄市","岡山區程香里",6,0,6,2,1,1,2,3
10409,"高雄市","岡山區大遼里",3,1,2,2,1,1,1,1
10409,"高雄市","岡山區大莊里",0,0,0,5,3,2,1,0
10409,"高雄市","岡山區福興里",1,1,0,1,1,0,1,0
10409,"高雄市","岡山區岡山里",5,3,2,12,7,5,5,2
10409,"高雄市","岡山區和平里",2,0,2,0,0,0,0,0
10409,"高雄市","岡山區後紅里",4,3,1,7,3,4,4,3
10409,"高雄市","岡山區後協里",5,4,1,5,4,1,8,3
10409,"高雄市","岡山區華崗里",3,2,1,5,3,2,1,0
10409,"高雄市","岡山區嘉峰里",3,2,1,1,0,1,4,1
10409,"高雄市","岡山區嘉興里",3,0,3,7,5,2,3,2
10409,"高雄市","岡山區劉厝里",1,1,0,2,2,0,1,0
10409,"高雄市","岡山區平安里",0,0,0,1,1,0,1,0
10409,"高雄市","岡山區前峰里",6,4,2,5,5,0,3,3
10409,"高雄市","岡山區仁壽里",3,2,1,6,4,2,2,0
10409,"高雄市","岡山區仁義里",2,0,2,5,3,2,2,1
10409,"高雄市","岡山區三和里",0,0,0,1,1,0,1,1
10409,"高雄市","岡山區石潭里",2,0,2,1,0,1,3,1
10409,"高雄市","岡山區壽峰里",1,1,0,2,2,0,2,3
10409,"高雄市","岡山區壽天里",3,0,3,3,3,0,2,0
10409,"高雄市","岡山區台上里",13,9,4,6,1,5,6,0
10409,"高雄市","岡山區潭底里",1,1,0,1,1,0,1,0
10409,"高雄市","岡山區灣裡里",4,2,2,4,3,1,7,1
10409,"高雄市","岡山區維仁里",2,2,0,3,1,2,0,1
10409,"高雄市","岡山區為隨里",1,1,0,2,1,1,1,0
10409,"高雄市","岡山區協和里",4,2,2,3,1,2,5,2
10409,"高雄市","岡山區協榮里",2,1,1,5,2,3,4,2
10409,"高雄市","岡山區信義里",2,2,0,3,1,2,0,0
10409,"高雄市","岡山區忠孝里",3,2,1,6,3,3,1,2
10409,"高雄市","岡山區竹圍里",12,3,9,5,4,1,10,2
10409,"高雄市","鼓山區寶樹里",4,1,3,5,3,2,0,1
10409,"高雄市","鼓山區登山里",1,1,0,1,0,1,0,0
10409,"高雄市","鼓山區峰南里",2,1,1,2,1,1,1,0
10409,"高雄市","鼓山區鼓峰里",0,0,0,9,8,1,1,1
10409,"高雄市","鼓山區鼓岩里",4,2,2,0,0,0,1,0
10409,"高雄市","鼓山區光化里",1,0,1,5,3,2,1,0
10409,"高雄市","鼓山區光榮里",5,4,1,9,4,5,2,0
10409,"高雄市","鼓山區河邊里",0,0,0,2,1,1,2,1
10409,"高雄市","鼓山區厚生里",5,4,1,7,6,1,9,1
10409,"高雄市","鼓山區華豐里",7,3,4,6,5,1,3,2
10409,"高雄市","鼓山區惠安里",0,0,0,1,1,0,1,1
10409,"高雄市","鼓山區建國里",7,4,3,7,5,2,2,0
10409,"高雄市","鼓山區麗興里",2,0,2,1,1,0,0,1
10409,"高雄市","鼓山區龍井里",0,0,0,5,2,3,0,0
10409,"高雄市","鼓山區龍水里",52,27,25,11,7,4,41,12
10409,"高雄市","鼓山區龍子里",42,20,22,12,10,2,16,4
10409,"高雄市","鼓山區綠川里",3,1,2,8,5,3,3,1
10409,"高雄市","鼓山區民強里",4,1,3,4,2,2,5,1
10409,"高雄市","鼓山區民族里",3,2,1,0,0,0,2,4
10409,"高雄市","鼓山區明誠里",38,24,14,10,6,4,20,13
10409,"高雄市","鼓山區內惟里",0,0,0,2,1,1,2,0
10409,"高雄市","鼓山區平和里",8,6,2,2,1,1,4,1
10409,"高雄市","鼓山區前峰里",9,6,3,1,0,1,5,2
10409,"高雄市","鼓山區山下里",1,0,1,3,1,2,3,0
10409,"高雄市","鼓山區哨船頭里",4,2,2,2,2,0,1,0
10409,"高雄市","鼓山區壽山里",4,2,2,5,4,1,3,1
10409,"高雄市","鼓山區樹德里",1,0,1,1,0,1,1,0
10409,"高雄市","鼓山區桃源里",0,0,0,2,1,1,0,2
10409,"高雄市","鼓山區維生里",1,1,0,3,2,1,3,1
10409,"高雄市","鼓山區新民里",2,1,1,1,1,0,1,0
10409,"高雄市","鼓山區興宗里",1,1,0,2,0,2,0,1
10409,"高雄市","鼓山區雄峰里",2,1,1,2,2,0,0,0
10409,"高雄市","鼓山區延平里",1,0,1,2,2,0,0,0
10409,"高雄市","鼓山區裕豐里",4,1,3,1,0,1,5,1
10409,"高雄市","鼓山區裕興里",5,4,1,6,4,2,9,3
10409,"高雄市","鼓山區正德里",5,0,5,2,1,1,1,0
10409,"高雄市","鼓山區忠正里",6,3,3,7,5,2,2,3
10409,"高雄市","鼓山區自強里",1,1,0,3,2,1,1,0
10409,"高雄市","湖內區大湖里",2,1,1,4,1,3,2,1
10409,"高雄市","湖內區公舘里",3,1,2,2,1,1,0,0
10409,"高雄市","湖內區海埔里",2,1,1,1,1,0,1,1
10409,"高雄市","湖內區海山里",0,0,0,1,1,0,1,0
10409,"高雄市","湖內區湖東里",3,2,1,4,3,1,6,1
10409,"高雄市","湖內區湖內里",7,3,4,3,3,0,7,2
10409,"高雄市","湖內區劉家里",1,1,0,5,2,3,1,0
10409,"高雄市","湖內區太爺里",2,0,2,3,1,2,0,0
10409,"高雄市","湖內區田尾里",2,0,2,2,1,1,0,0
10409,"高雄市","湖內區文賢里",2,1,1,6,2,4,1,1
10409,"高雄市","湖內區葉厝里",7,4,3,1,0,1,1,0
10409,"高雄市","湖內區逸賢里",0,0,0,2,0,2,0,0
10409,"高雄市","湖內區中賢里",4,1,3,3,3,0,2,1
10409,"高雄市","湖內區忠興里",0,0,0,2,1,1,0,0
10409,"高雄市","茄萣區白雲里",3,2,1,5,5,0,3,0
10409,"高雄市","茄萣區保定里",2,1,1,4,3,1,2,1
10409,"高雄市","茄萣區大定里",3,2,1,6,2,4,2,0
10409,"高雄市","茄萣區福德里",0,0,0,0,0,0,3,0
10409,"高雄市","茄萣區光定里",3,2,1,3,2,1,1,0
10409,"高雄市","茄萣區和協里",1,0,1,5,3,2,1,0
10409,"高雄市","茄萣區吉定里",2,1,1,4,3,1,2,0
10409,"高雄市","茄萣區嘉安里",4,2,2,5,3,2,3,0
10409,"高雄市","茄萣區嘉賜里",10,5,5,4,3,1,2,1
10409,"高雄市","茄萣區嘉定里",1,0,1,1,0,1,0,0
10409,"高雄市","茄萣區嘉福里",0,0,0,4,3,1,2,1
10409,"高雄市","茄萣區嘉樂里",4,3,1,1,1,0,3,0
10409,"高雄市","茄萣區嘉泰里",1,0,1,7,4,3,2,0
10409,"高雄市","茄萣區崎漏里",4,0,4,7,5,2,11,2
10409,"高雄市","茄萣區萬福里",0,0,0,3,1,2,0,1
10409,"高雄市","甲仙區寶隆里",1,1,0,1,1,0,0,0
10409,"高雄市","甲仙區大田里",1,1,0,4,3,1,0,0
10409,"高雄市","甲仙區東安里",0,0,0,4,1,3,0,0
10409,"高雄市","甲仙區關山里",0,0,0,2,1,1,0,0
10409,"高雄市","甲仙區和安里",0,0,0,2,2,0,0,0
10409,"高雄市","甲仙區西安里",0,0,0,4,3,1,0,0
10409,"高雄市","甲仙區小林里",0,0,0,3,3,0,0,0
10409,"高雄市","林園區北汕里",5,3,2,1,0,1,1,0
10409,"高雄市","林園區頂厝里",8,5,3,3,3,0,5,2
10409,"高雄市","林園區東林里",6,3,3,3,1,2,1,0
10409,"高雄市","林園區東汕里",0,0,0,3,1,2,1,0
10409,"高雄市","林園區鳳芸里",3,1,2,1,1,0,3,2
10409,"高雄市","林園區港埔里",4,1,3,2,1,1,1,0
10409,"高雄市","林園區港嘴里",5,2,3,3,2,1,0,1
10409,"高雄市","林園區龔厝里",0,0,0,3,2,1,5,1
10409,"高雄市","林園區廣應里",6,2,4,4,1,3,6,1
10409,"高雄市","林園區林家里",5,2,3,5,1,4,0,0
10409,"高雄市","林園區林內里",4,3,1,7,6,1,4,1
10409,"高雄市","林園區林園里",6,4,2,3,1,2,2,2
10409,"高雄市","林園區仁愛里",3,1,2,1,1,0,0,1
10409,"高雄市","林園區潭頭里",2,2,0,3,2,1,2,1
10409,"高雄市","林園區王公里",5,4,1,4,2,2,4,2
10409,"高雄市","林園區文賢里",7,5,2,3,1,2,2,1
10409,"高雄市","林園區五福里",5,4,1,3,3,0,4,1
10409,"高雄市","林園區溪州里",8,7,1,5,4,1,7,2
10409,"高雄市","林園區西汕里",2,1,1,3,2,1,0,0
10409,"高雄市","林園區西溪里",4,2,2,5,4,1,4,1
10409,"高雄市","林園區中厝里",2,1,1,2,2,0,4,1
10409,"高雄市","林園區中門里",3,1,2,2,1,1,2,1
10409,"高雄市","林園區中汕里",6,2,4,7,6,1,5,1
10409,"高雄市","林園區中芸里",2,2,0,4,1,3,1,1
10409,"高雄市","苓雅區安祥里",4,3,1,5,2,3,3,2
10409,"高雄市","苓雅區博仁里",0,0,0,0,0,0,1,1
10409,"高雄市","苓雅區朝陽里",5,4,1,3,1,2,3,0
10409,"高雄市","苓雅區城北里",0,0,0,0,0,0,0,1
10409,"高雄市","苓雅區城東里",5,1,4,3,0,3,3,1
10409,"高雄市","苓雅區城西里",1,1,0,0,0,0,0,0
10409,"高雄市","苓雅區福地里",0,0,0,5,3,2,6,0
10409,"高雄市","苓雅區福東里",3,2,1,5,2,3,0,1
10409,"高雄市","苓雅區福海里",3,0,3,2,1,1,0,0
10409,"高雄市","苓雅區福居里",4,2,2,4,2,2,2,1
10409,"高雄市","苓雅區福康里",1,0,1,4,3,1,1,0
10409,"高雄市","苓雅區福隆里",6,4,2,7,2,5,1,1
10409,"高雄市","苓雅區福南里",3,0,3,4,3,1,0,1
10409,"高雄市","苓雅區福人里",4,2,2,4,3,1,2,1
10409,"高雄市","苓雅區福壽里",0,0,0,2,1,1,2,0
10409,"高雄市","苓雅區福西里",1,1,0,2,2,0,2,2
10409,"高雄市","苓雅區福祥里",2,1,1,4,3,1,1,0
10409,"高雄市","苓雅區鼓中里",0,0,0,3,3,0,1,0
10409,"高雄市","苓雅區光華里",1,0,1,1,1,0,0,0
10409,"高雄市","苓雅區廣澤里",0,0,0,3,0,3,1,0
10409,"高雄市","苓雅區和煦里",6,2,4,1,0,1,0,1
10409,"高雄市","苓雅區華堂里",2,2,0,2,1,1,2,0
10409,"高雄市","苓雅區建軍里",4,4,0,4,3,1,2,0
10409,"高雄市","苓雅區凱旋里",1,1,0,1,1,0,1,2
10409,"高雄市","苓雅區林安里",1,0,1,1,1,0,2,1
10409,"高雄市","苓雅區林德里",1,1,0,8,3,5,2,0
10409,"高雄市","苓雅區林富里",3,2,1,3,0,3,0,1
10409,"高雄市","苓雅區林貴里",2,2,0,0,0,0,1,1
10409,"高雄市","苓雅區林華里",3,2,1,6,6,0,2,0
10409,"高雄市","苓雅區林靖里",1,0,1,1,1,0,2,0
10409,"高雄市","苓雅區林南里",3,1,2,1,1,0,3,0
10409,"高雄市","苓雅區林泉里",5,2,3,1,1,0,2,0
10409,"高雄市","苓雅區林榮里",4,3,1,10,3,7,8,3
10409,"高雄市","苓雅區林圍里",8,6,2,1,1,0,1,0
10409,"高雄市","苓雅區林西里",2,1,1,3,2,1,1,0
10409,"高雄市","苓雅區林興里",4,2,2,6,6,0,1,0
10409,"高雄市","苓雅區林中里",6,0,6,6,3,3,4,1
10409,"高雄市","苓雅區苓東里",0,0,0,5,2,3,0,0
10409,"高雄市","苓雅區苓昇里",0,0,0,5,2,3,2,2
10409,"高雄市","苓雅區苓雅里",0,0,0,1,0,1,0,1
10409,"高雄市","苓雅區苓中里",1,0,1,3,2,1,2,1
10409,"高雄市","苓雅區苓洲里",2,2,0,1,1,0,3,0
10409,"高雄市","苓雅區美田里",2,1,1,4,3,1,3,0
10409,"高雄市","苓雅區民主里",6,2,4,6,2,4,5,1
10409,"高雄市","苓雅區普天里",8,4,4,4,2,2,3,0
10409,"高雄市","苓雅區普照里",4,4,0,6,4,2,2,2
10409,"高雄市","苓雅區晴朗里",0,0,0,5,5,0,2,0
10409,"高雄市","苓雅區人和里",2,1,1,2,2,0,1,2
10409,"高雄市","苓雅區仁政里",1,1,0,0,0,0,0,0
10409,"高雄市","苓雅區日中里",5,3,2,0,0,0,2,0
10409,"高雄市","苓雅區尚義里",3,2,1,2,0,2,1,1
10409,"高雄市","苓雅區田西里",1,0,1,4,1,3,1,1
10409,"高雄市","苓雅區同慶里",5,3,2,3,2,1,0,0
10409,"高雄市","苓雅區衛武里",5,2,3,5,4,1,1,1
10409,"高雄市","苓雅區文昌里",8,7,1,3,2,1,5,0
10409,"高雄市","苓雅區五福里",3,3,0,3,2,1,6,2
10409,"高雄市","苓雅區五權里",3,1,2,6,3,3,2,1
10409,"高雄市","苓雅區意誠里",5,3,2,3,2,1,5,4
10409,"高雄市","苓雅區英明里",2,1,1,1,1,0,1,2
10409,"高雄市","苓雅區永康里",4,0,4,1,1,0,2,2
10409,"高雄市","苓雅區正大里",11,7,4,3,2,1,11,1
10409,"高雄市","苓雅區正道里",3,1,2,7,3,4,7,1
10409,"高雄市","苓雅區正仁里",5,3,2,3,0,3,2,1
10409,"高雄市","苓雅區正文里",6,5,1,3,1,2,5,0
10409,"高雄市","苓雅區正心里",10,6,4,6,2,4,3,1
10409,"高雄市","苓雅區正言里",5,3,2,1,1,0,4,2
10409,"高雄市","苓雅區正義里",5,4,1,4,2,2,3,1
10409,"高雄市","苓雅區中正里",4,2,2,4,3,1,3,0
10409,"高雄市","苓雅區奏捷里",5,5,0,6,5,1,2,1
10409,"高雄市","六龜區寶來里",0,0,0,1,1,0,0,0
10409,"高雄市","六龜區大津里",0,0,0,1,0,1,0,0
10409,"高雄市","六龜區荖濃里",1,0,1,2,2,0,3,1
10409,"高雄市","六龜區六龜里",1,0,1,1,0,1,1,1
10409,"高雄市","六龜區文武里",1,0,1,5,2,3,1,0
10409,"高雄市","六龜區新發里",2,1,1,6,2,4,0,0
10409,"高雄市","六龜區新寮里",1,1,0,0,0,0,0,0
10409,"高雄市","六龜區新威里",0,0,0,0,0,0,0,0
10409,"高雄市","六龜區新興里",0,0,0,3,1,2,0,0
10409,"高雄市","六龜區興龍里",1,1,0,1,0,1,2,2
10409,"高雄市","六龜區義寶里",3,1,2,1,1,0,0,1
10409,"高雄市","六龜區中興里",1,0,1,1,0,1,3,0
10409,"高雄市","路竹區北嶺里",2,1,1,2,1,1,0,0
10409,"高雄市","路竹區頂寮里",2,2,0,1,0,1,2,1
10409,"高雄市","路竹區後鄉里",1,0,1,1,1,0,0,0
10409,"高雄市","路竹區甲北里",10,4,6,5,5,0,1,0
10409,"高雄市","路竹區甲南里",7,4,3,4,4,0,3,1
10409,"高雄市","路竹區三爺里",6,3,3,1,0,1,0,0
10409,"高雄市","路竹區社東里",2,2,0,7,2,5,2,2
10409,"高雄市","路竹區社南里",4,1,3,3,3,0,6,1
10409,"高雄市","路竹區社西里",4,1,3,4,2,2,4,0
10409,"高雄市","路竹區社中里",0,0,0,3,2,1,0,1
10409,"高雄市","路竹區文北里",4,0,4,8,5,3,8,2
10409,"高雄市","路竹區文南里",2,1,1,4,1,3,1,0
10409,"高雄市","路竹區下坑里",3,3,0,4,3,1,3,1
10409,"高雄市","路竹區新達里",0,0,0,2,1,1,2,1
10409,"高雄市","路竹區鴨寮里",3,0,3,4,4,0,4,1
10409,"高雄市","路竹區竹東里",2,2,0,6,4,2,3,2
10409,"高雄市","路竹區竹滬里",8,6,2,3,2,1,8,0
10409,"高雄市","路竹區竹南里",3,0,3,4,3,1,2,0
10409,"高雄市","路竹區竹西里",5,1,4,6,3,3,2,1
10409,"高雄市","路竹區竹園里",3,2,1,2,0,2,1,0
10409,"高雄市","茂林區多納里",1,1,0,1,1,0,0,1
10409,"高雄市","茂林區茂林里",3,2,1,0,0,0,2,0
10409,"高雄市","茂林區萬山里",0,0,0,1,1,0,0,2
10409,"高雄市","美濃區德興里",1,1,0,4,1,3,0,0
10409,"高雄市","美濃區東門里",1,0,1,0,0,0,0,0
10409,"高雄市","美濃區福安里",2,0,2,7,6,1,4,2
10409,"高雄市","美濃區廣德里",1,1,0,2,1,1,0,0
10409,"高雄市","美濃區廣林里",3,1,2,6,4,2,0,0
10409,"高雄市","美濃區合和里",2,0,2,3,2,1,1,1
10409,"高雄市","美濃區吉東里",1,0,1,3,2,1,1,0
10409,"高雄市","美濃區吉和里",3,2,1,3,2,1,2,1
10409,"高雄市","美濃區吉洋里",1,1,0,5,2,3,1,0
10409,"高雄市","美濃區龍肚里",1,1,0,7,3,4,0,1
10409,"高雄市","美濃區龍山里",1,1,0,6,4,2,2,0
10409,"高雄市","美濃區祿興里",3,0,3,6,5,1,2,0
10409,"高雄市","美濃區瀰濃里",0,0,0,6,5,1,3,0
10409,"高雄市","美濃區清水里",3,1,2,9,5,4,1,0
10409,"高雄市","美濃區獅山里",1,1,0,5,1,4,3,1
10409,"高雄市","美濃區泰安里",4,2,2,3,1,2,2,0
10409,"高雄市","美濃區興隆里",1,0,1,1,1,0,0,0
10409,"高雄市","美濃區中壇里",5,2,3,2,2,0,1,2
10409,"高雄市","美濃區中圳里",3,3,0,1,0,1,2,0
10409,"高雄市","彌陀區光和里",1,1,0,1,1,0,2,3
10409,"高雄市","彌陀區過港里",1,0,1,1,1,0,1,0
10409,"高雄市","彌陀區海尾里",1,0,1,3,3,0,0,0
10409,"高雄市","彌陀區舊港里",3,3,0,2,0,2,2,0
10409,"高雄市","彌陀區漯底里",6,4,2,5,5,0,2,1
10409,"高雄市","彌陀區彌靖里",1,1,0,1,0,1,4,0
10409,"高雄市","彌陀區彌仁里",1,1,0,2,2,0,0,0
10409,"高雄市","彌陀區彌壽里",4,0,4,2,1,1,1,0
10409,"高雄市","彌陀區彌陀里",7,2,5,1,1,0,2,1
10409,"高雄市","彌陀區南寮里",5,4,1,1,1,0,3,2
10409,"高雄市","彌陀區文安里",2,0,2,5,3,2,1,0
10409,"高雄市","彌陀區鹽埕里",1,0,1,5,4,1,3,0
10409,"高雄市","那瑪夏區達卡努瓦里",4,2,2,3,2,1,1,0
10409,"高雄市","那瑪夏區瑪雅里",1,0,1,0,0,0,1,1
10409,"高雄市","那瑪夏區南沙魯里",1,1,0,0,0,0,0,2
10409,"高雄市","楠梓區翠屏里",33,16,17,18,15,3,27,6
10409,"高雄市","楠梓區大昌里",4,1,3,4,2,2,1,1
10409,"高雄市","楠梓區東寧里",13,5,8,2,2,0,9,3
10409,"高雄市","楠梓區福昌里",3,2,1,1,1,0,2,0
10409,"高雄市","楠梓區廣昌里",6,5,1,11,6,5,5,2
10409,"高雄市","楠梓區國昌里",2,1,1,3,2,1,6,3
10409,"高雄市","楠梓區和昌里",1,0,1,5,2,3,1,3
10409,"高雄市","楠梓區宏昌里",5,3,2,5,2,3,8,5
10409,"高雄市","楠梓區宏南里",2,0,2,1,0,1,2,0
10409,"高雄市","楠梓區宏榮里",6,5,1,8,7,1,3,2
10409,"高雄市","楠梓區宏毅里",0,0,0,7,6,1,0,0
10409,"高雄市","楠梓區惠豐里",9,4,5,5,4,1,3,5
10409,"高雄市","楠梓區惠民里",10,5,5,4,1,3,5,1
10409,"高雄市","楠梓區惠楠里",4,2,2,5,4,1,3,1
10409,"高雄市","楠梓區加昌里",9,3,6,6,4,2,16,7
10409,"高雄市","楠梓區建昌里",4,3,1,2,1,1,5,2
10409,"高雄市","楠梓區金田里",7,4,3,11,7,4,1,0
10409,"高雄市","楠梓區錦屏里",3,2,1,7,3,4,4,1
10409,"高雄市","楠梓區久昌里",3,1,2,1,1,0,5,2
10409,"高雄市","楠梓區藍田里",14,7,7,6,2,4,7,0
10409,"高雄市","楠梓區隆昌里",3,1,2,4,4,0,8,2
10409,"高雄市","楠梓區清豐里",44,26,18,17,14,3,24,6
10409,"高雄市","楠梓區慶昌里",5,2,3,4,2,2,4,1
10409,"高雄市","楠梓區仁昌里",6,4,2,6,5,1,10,0
10409,"高雄市","楠梓區稔田里",3,3,0,2,1,1,0,0
10409,"高雄市","楠梓區瑞屏里",4,2,2,5,4,1,9,0
10409,"高雄市","楠梓區盛昌里",5,1,4,5,4,1,7,1
10409,"高雄市","楠梓區泰昌里",0,0,0,2,2,0,3,0
10409,"高雄市","楠梓區五常里",8,2,6,3,1,2,13,4
10409,"高雄市","楠梓區享平里",6,2,4,1,0,1,4,1
10409,"高雄市","楠梓區興昌里",11,3,8,2,1,1,5,0
10409,"高雄市","楠梓區秀昌里",3,1,2,2,1,1,2,1
10409,"高雄市","楠梓區玉屏里",2,1,1,5,2,3,6,3
10409,"高雄市","楠梓區裕昌里",7,6,1,5,4,1,9,5
10409,"高雄市","楠梓區中和里",7,3,4,2,2,0,4,0
10409,"高雄市","楠梓區中興里",2,1,1,1,1,0,1,2
10409,"高雄市","楠梓區中陽里",4,2,2,9,5,4,4,1
10409,"高雄市","內門區東埔里",1,1,0,0,0,0,0,0
10409,"高雄市","內門區溝坪里",4,3,1,3,1,2,3,0
10409,"高雄市","內門區觀亭里",3,1,2,4,2,2,3,0
10409,"高雄市","內門區光興里",1,1,0,2,2,0,1,1
10409,"高雄市","內門區金竹里",0,0,0,2,1,1,0,0
10409,"高雄市","內門區木柵里",0,0,0,2,0,2,2,0
10409,"高雄市","內門區內東里",3,2,1,3,2,1,1,1
10409,"高雄市","內門區內豊里",1,1,0,1,1,0,0,0
10409,"高雄市","內門區內門里",2,2,0,3,1,2,2,1
10409,"高雄市","內門區內南里",0,0,0,0,0,0,0,0
10409,"高雄市","內門區內興里",0,0,0,1,0,1,0,0
10409,"高雄市","內門區瑞山里",1,0,1,1,0,1,0,0
10409,"高雄市","內門區三平里",2,1,1,1,1,0,2,0
10409,"高雄市","內門區石坑里",2,0,2,3,2,1,0,0
10409,"高雄市","內門區永富里",1,1,0,0,0,0,1,1
10409,"高雄市","內門區永吉里",0,0,0,1,1,0,0,0
10409,"高雄市","內門區永興里",0,0,0,2,1,1,0,1
10409,"高雄市","內門區中埔里",0,0,0,0,0,0,1,0
10409,"高雄市","鳥松區大華里",12,7,5,8,6,2,17,4
10409,"高雄市","鳥松區大竹里",1,0,1,2,2,0,1,0
10409,"高雄市","鳥松區坔埔里",4,4,0,3,2,1,3,3
10409,"高雄市","鳥松區華美里",8,3,5,4,2,2,6,2
10409,"高雄市","鳥松區夢裡里",12,5,7,8,5,3,7,0
10409,"高雄市","鳥松區鳥松里",18,9,9,17,12,5,21,4
10409,"高雄市","鳥松區仁美里",13,6,7,8,8,0,4,2
10409,"高雄市","旗津區安順里",3,2,1,0,0,0,1,1
10409,"高雄市","旗津區北汕里",4,3,1,7,4,3,1,1
10409,"高雄市","旗津區慈愛里",4,2,2,3,2,1,1,2
10409,"高雄市","旗津區復興里",8,3,5,4,4,0,7,3
10409,"高雄市","旗津區南汕里",2,1,1,4,3,1,3,1
10409,"高雄市","旗津區旗下里",6,5,1,4,1,3,1,0
10409,"高雄市","旗津區上竹里",8,3,5,1,0,1,5,1
10409,"高雄市","旗津區實踐里",3,0,3,3,2,1,0,1
10409,"高雄市","旗津區永安里",2,1,1,3,2,1,1,0
10409,"高雄市","旗津區振興里",5,2,3,3,2,1,3,0
10409,"高雄市","旗津區中華里",6,5,1,3,2,1,0,0
10409,"高雄市","旗津區中興里",10,4,6,5,4,1,6,4
10409,"高雄市","旗津區中洲里",3,3,0,4,4,0,3,0
10409,"高雄市","旗山區大德里",3,0,3,3,2,1,1,3
10409,"高雄市","旗山區大林里",2,1,1,3,2,1,3,0
10409,"高雄市","旗山區大山里",2,2,0,5,4,1,0,0
10409,"高雄市","旗山區東昌里",2,0,2,4,2,2,0,0
10409,"高雄市","旗山區東平里",5,3,2,3,1,2,1,0
10409,"高雄市","旗山區廣福里",2,2,0,2,1,1,0,1
10409,"高雄市","旗山區鯤洲里",2,2,0,5,4,1,2,0
10409,"高雄市","旗山區湄洲里",1,1,0,1,0,1,1,1
10409,"高雄市","旗山區南勝里",5,5,0,4,3,1,4,2
10409,"高雄市","旗山區南洲里",1,1,0,4,2,2,1,0
10409,"高雄市","旗山區瑞吉里",3,3,0,3,1,2,1,2
10409,"高雄市","旗山區三協里",2,1,1,6,3,3,1,2
10409,"高雄市","旗山區上洲里",2,1,1,4,3,1,0,0
10409,"高雄市","旗山區太平里",3,0,3,2,1,1,3,0
10409,"高雄市","旗山區新光里",1,0,1,1,0,1,2,0
10409,"高雄市","旗山區永和里",8,5,3,2,2,0,3,1
10409,"高雄市","旗山區圓富里",5,5,0,9,8,1,1,2
10409,"高雄市","旗山區中寮里",0,0,0,0,0,0,0,0
10409,"高雄市","旗山區中正里",4,3,1,3,3,0,1,1
10409,"高雄市","旗山區中洲里",1,1,0,2,1,1,3,1
10409,"高雄市","旗山區竹峰里",0,0,0,5,2,3,1,0
10409,"高雄市","前金區北金里",0,0,0,3,1,2,1,1
10409,"高雄市","前金區博孝里",0,0,0,0,0,0,1,0
10409,"高雄市","前金區草江里",2,1,1,2,0,2,2,0
10409,"高雄市","前金區東金里",1,1,0,3,2,1,1,1
10409,"高雄市","前金區復元里",0,0,0,0,0,0,2,0
10409,"高雄市","前金區國民里",1,0,1,1,0,1,1,1
10409,"高雄市","前金區後金里",1,1,0,0,0,0,0,0
10409,"高雄市","前金區林投里",1,0,1,2,1,1,2,0
10409,"高雄市","前金區民生里",0,0,0,1,1,0,1,0
10409,"高雄市","前金區青山里",0,0,0,1,0,1,2,0
10409,"高雄市","前金區榮復里",0,0,0,3,2,1,2,1
10409,"高雄市","前金區三川里",0,0,0,0,0,0,0,2
10409,"高雄市","前金區社東里",1,1,0,2,2,0,2,2
10409,"高雄市","前金區社西里",0,0,0,1,1,0,0,0
10409,"高雄市","前金區文東里",0,0,0,3,1,2,2,1
10409,"高雄市","前金區文西里",2,1,1,3,2,1,2,0
10409,"高雄市","前金區新生里",8,5,3,3,2,1,7,2
10409,"高雄市","前金區長城里",0,0,0,3,2,1,1,0
10409,"高雄市","前金區長生里",2,1,1,2,1,1,1,1
10409,"高雄市","前金區長興里",5,3,2,3,1,2,1,0
10409,"高雄市","前鎮區草衙里",15,9,6,12,4,8,9,7
10409,"高雄市","前鎮區德昌里",2,0,2,3,3,0,5,0
10409,"高雄市","前鎮區復國里",4,3,1,8,5,3,4,1
10409,"高雄市","前鎮區建隆里",3,2,1,1,1,0,0,0
10409,"高雄市","前鎮區良和里",5,4,1,3,2,1,4,1
10409,"高雄市","前鎮區民權里",4,2,2,6,3,3,5,1
10409,"高雄市","前鎮區明道里",0,0,0,1,0,1,1,0
10409,"高雄市","前鎮區明禮里",1,0,1,3,2,1,0,1
10409,"高雄市","前鎮區明孝里",0,0,0,3,1,2,3,0
10409,"高雄市","前鎮區明義里",2,0,2,3,3,0,3,0
10409,"高雄市","前鎮區明正里",13,9,4,2,1,1,2,3
10409,"高雄市","前鎮區平昌里",1,0,1,0,0,0,0,1
10409,"高雄市","前鎮區平等里",6,2,4,6,5,1,5,1
10409,"高雄市","前鎮區前鎮里",3,2,1,3,1,2,3,0
10409,"高雄市","前鎮區仁愛里",1,0,1,1,1,0,0,0
10409,"高雄市","前鎮區瑞北里",10,4,6,1,1,0,2,1
10409,"高雄市","前鎮區瑞昌里",11,2,9,2,1,1,5,2
10409,"高雄市","前鎮區瑞誠里",1,0,1,4,2,2,4,0
10409,"高雄市","前鎮區瑞東里",6,3,3,5,4,1,0,3
10409,"高雄市","前鎮區瑞豐里",2,2,0,4,1,3,5,1
10409,"高雄市","前鎮區瑞崗里",6,3,3,6,5,1,1,1
10409,"高雄市","前鎮區瑞和里",4,2,2,4,2,2,0,0
10409,"高雄市","前鎮區瑞華里",2,1,1,1,1,0,3,4
10409,"高雄市","前鎮區瑞隆里",3,2,1,6,4,2,2,2
10409,"高雄市","前鎮區瑞南里",6,3,3,6,6,0,6,3
10409,"高雄市","前鎮區瑞平里",4,2,2,3,2,1,4,2
10409,"高雄市","前鎮區瑞文里",8,5,3,2,2,0,1,1
10409,"高雄市","前鎮區瑞西里",6,3,3,5,4,1,2,3
10409,"高雄市","前鎮區瑞祥里",8,2,6,5,2,3,6,3
10409,"高雄市","前鎮區瑞興里",3,0,3,2,1,1,2,1
10409,"高雄市","前鎮區瑞竹里",7,5,2,3,3,0,3,0
10409,"高雄市","前鎮區盛豐里",3,2,1,4,2,2,1,2
10409,"高雄市","前鎮區盛興里",3,2,1,2,0,2,8,3
10409,"高雄市","前鎮區西甲里",4,3,1,6,4,2,3,0
10409,"高雄市","前鎮區西山里",4,0,4,1,0,1,4,2
10409,"高雄市","前鎮區信德里",3,3,0,6,4,2,1,0
10409,"高雄市","前鎮區信義里",1,0,1,7,2,5,2,0
10409,"高雄市","前鎮區興邦里",11,6,5,1,1,0,5,1
10409,"高雄市","前鎮區興東里",10,4,6,4,2,2,9,0
10409,"高雄市","前鎮區興化里",0,0,0,0,0,0,1,1
10409,"高雄市","前鎮區興仁里",2,1,1,2,2,0,2,1
10409,"高雄市","前鎮區興中里",1,0,1,2,1,1,5,2
10409,"高雄市","前鎮區振興里",5,4,1,4,2,2,2,0
10409,"高雄市","前鎮區鎮北里",2,1,1,4,4,0,0,0
10409,"高雄市","前鎮區鎮昌里",3,1,2,5,4,1,5,0
10409,"高雄市","前鎮區鎮東里",1,1,0,7,3,4,3,0
10409,"高雄市","前鎮區鎮海里",6,2,4,3,2,1,3,3
10409,"高雄市","前鎮區鎮榮里",3,2,1,3,2,1,4,0
10409,"高雄市","前鎮區鎮陽里",0,0,0,1,1,0,2,0
10409,"高雄市","前鎮區鎮中里",0,0,0,0,0,0,2,0
10409,"高雄市","前鎮區忠誠里",4,3,1,4,1,3,2,1
10409,"高雄市","前鎮區忠純里",5,3,2,8,6,2,6,2
10409,"高雄市","前鎮區忠孝里",5,3,2,4,2,2,2,0
10409,"高雄市","前鎮區竹北里",5,1,4,1,1,0,7,0
10409,"高雄市","前鎮區竹東里",2,1,1,3,1,2,2,1
10409,"高雄市","前鎮區竹南里",15,7,8,2,2,0,8,1
10409,"高雄市","前鎮區竹內里",1,1,0,3,1,2,1,1
10409,"高雄市","前鎮區竹西里",3,0,3,6,1,5,6,0
10409,"高雄市","前鎮區竹中里",6,2,4,7,3,4,7,2
10409,"高雄市","橋頭區白樹里",5,2,3,4,3,1,2,3
10409,"高雄市","橋頭區筆秀里",2,1,1,1,0,1,2,0
10409,"高雄市","橋頭區德松里",4,2,2,4,2,2,2,0
10409,"高雄市","橋頭區頂鹽里",3,1,2,0,0,0,0,0
10409,"高雄市","橋頭區東林里",1,0,1,8,5,3,2,2
10409,"高雄市","橋頭區甲北里",1,1,0,3,1,2,3,1
10409,"高雄市","橋頭區甲南里",1,0,1,5,4,1,3,2
10409,"高雄市","橋頭區橋南里",2,1,1,3,1,2,4,2
10409,"高雄市","橋頭區橋頭里",3,3,0,3,2,1,2,1
10409,"高雄市","橋頭區三德里",1,1,0,1,0,1,3,0
10409,"高雄市","橋頭區仕豐里",3,0,3,4,3,1,1,2
10409,"高雄市","橋頭區仕和里",7,3,4,6,2,4,3,0
10409,"高雄市","橋頭區仕隆里",2,1,1,11,6,5,1,0
10409,"高雄市","橋頭區西林里",2,0,2,2,1,1,1,1
10409,"高雄市","橋頭區新莊里",3,2,1,4,2,2,2,1
10409,"高雄市","橋頭區芋寮里",3,3,0,4,3,1,2,0
10409,"高雄市","橋頭區中崎里",1,0,1,0,0,0,0,0
10409,"高雄市","仁武區八卦里",32,21,11,12,11,1,22,6
10409,"高雄市","仁武區赤山里",13,7,6,5,4,1,4,1
10409,"高雄市","仁武區大灣里",7,3,4,5,4,1,7,1
10409,"高雄市","仁武區高楠里",1,1,0,3,1,2,1,0
10409,"高雄市","仁武區後安里",5,4,1,2,2,0,5,1
10409,"高雄市","仁武區考潭里",4,2,2,2,0,2,1,2
10409,"高雄市","仁武區仁慈里",3,3,0,2,0,2,3,0
10409,"高雄市","仁武區仁福里",0,0,0,5,4,1,1,1
10409,"高雄市","仁武區仁和里",10,4,6,7,5,2,7,2
10409,"高雄市","仁武區仁武里",12,6,6,6,2,4,3,1
10409,"高雄市","仁武區灣內里",27,14,13,8,3,5,9,5
10409,"高雄市","仁武區文武里",19,14,5,10,7,3,10,5
10409,"高雄市","仁武區烏林里",15,10,5,5,3,2,9,0
10409,"高雄市","仁武區五和里",11,7,4,3,2,1,6,1
10409,"高雄市","仁武區中華里",2,2,0,5,4,1,1,2
10409,"高雄市","仁武區竹後里",1,1,0,1,0,1,3,0
10409,"高雄市","三民區安邦里",9,6,3,3,1,2,7,1
10409,"高雄市","三民區安東里",9,4,5,3,0,3,3,2
10409,"高雄市","三民區安發里",4,1,3,5,3,2,6,2
10409,"高雄市","三民區安和里",3,2,1,5,2,3,1,1
10409,"高雄市","三民區安吉里",7,4,3,4,3,1,2,1
10409,"高雄市","三民區安康里",1,0,1,5,5,0,2,3
10409,"高雄市","三民區安寧里",1,0,1,4,2,2,3,1
10409,"高雄市","三民區安生里",2,0,2,4,3,1,0,0
10409,"高雄市","三民區安泰里",4,2,2,6,5,1,5,3
10409,"高雄市","三民區安宜里",0,0,0,6,4,2,3,2
10409,"高雄市","三民區寶安里",13,7,6,7,2,5,6,3
10409,"高雄市","三民區寶德里",6,3,3,6,3,3,1,3
10409,"高雄市","三民區寶國里",11,8,3,4,3,1,8,3
10409,"高雄市","三民區寶華里",6,4,2,4,2,2,1,0
10409,"高雄市","三民區寶龍里",5,2,3,4,0,4,10,1
10409,"高雄市","三民區寶民里",8,5,3,5,3,2,10,3
10409,"高雄市","三民區寶慶里",2,2,0,2,1,1,4,2
10409,"高雄市","三民區寶盛里",13,9,4,10,5,5,5,1
10409,"高雄市","三民區寶獅里",5,3,2,6,5,1,7,1
10409,"高雄市","三民區寶泰里",8,6,2,6,4,2,8,3
10409,"高雄市","三民區寶興里",11,8,3,3,1,2,6,2
10409,"高雄市","三民區寶業里",5,3,2,6,4,2,3,2
10409,"高雄市","三民區寶玉里",15,6,9,9,4,5,7,3
10409,"高雄市","三民區寶中里",7,2,5,5,2,3,3,0
10409,"高雄市","三民區寶珠里",9,4,5,9,6,3,9,3
10409,"高雄市","三民區本安里",11,5,6,3,2,1,4,1
10409,"高雄市","三民區本館里",12,4,8,10,6,4,9,3
10409,"高雄市","三民區本和里",11,5,6,5,4,1,11,3
10409,"高雄市","三民區本上里",6,4,2,4,1,3,3,0
10409,"高雄市","三民區本文里",1,0,1,1,0,1,1,2
10409,"高雄市","三民區本武里",2,2,0,0,0,0,3,0
10409,"高雄市","三民區本揚里",18,10,8,13,6,7,5,3
10409,"高雄市","三民區本元里",8,1,7,6,4,2,5,0
10409,"高雄市","三民區博愛里",1,0,1,3,2,1,2,2
10409,"高雄市","三民區博惠里",8,5,3,8,4,4,14,2
10409,"高雄市","三民區川東里",2,0,2,6,4,2,1,0
10409,"高雄市","三民區達德里",1,1,0,3,1,2,1,0
10409,"高雄市","三民區達明里",2,2,0,3,2,1,2,0
10409,"高雄市","三民區達仁里",6,3,3,1,0,1,1,0
10409,"高雄市","三民區達勇里",2,0,2,1,1,0,2,1
10409,"高雄市","三民區德北里",4,1,3,9,4,5,4,0
10409,"高雄市","三民區德東里",1,1,0,0,0,0,2,0
10409,"高雄市","三民區德仁里",6,4,2,7,4,3,3,0
10409,"高雄市","三民區德西里",4,2,2,1,1,0,2,1
10409,"高雄市","三民區德行里",2,1,1,4,2,2,2,1
10409,"高雄市","三民區德智里",6,4,2,6,2,4,4,0
10409,"高雄市","三民區鼎金里",9,1,8,3,2,1,10,2
10409,"高雄市","三民區鼎力里",6,3,3,9,3,6,1,0
10409,"高雄市","三民區鼎強里",4,4,0,5,2,3,7,2
10409,"高雄市","三民區鼎盛里",13,4,9,10,7,3,13,3
10409,"高雄市","三民區鼎泰里",45,25,20,20,15,5,17,10
10409,"高雄市","三民區鼎西里",10,6,4,7,5,2,5,4
10409,"高雄市","三民區鼎中里",6,2,4,1,0,1,3,1
10409,"高雄市","三民區豐裕里",4,2,2,2,2,0,0,3
10409,"高雄市","三民區鳳北里",3,2,1,5,4,1,0,1
10409,"高雄市","三民區鳳南里",0,0,0,5,2,3,0,0
10409,"高雄市","三民區港東里",4,3,1,5,3,2,1,0
10409,"高雄市","三民區港西里",1,0,1,1,0,1,0,0
10409,"高雄市","三民區港新里",1,1,0,4,2,2,3,1
10409,"高雄市","三民區建東里",0,0,0,1,1,0,0,1
10409,"高雄市","三民區精華里",2,1,1,2,0,2,2,1
10409,"高雄市","三民區力行里",1,0,1,1,1,0,1,0
10409,"高雄市","三民區立誠里",0,0,0,1,0,1,0,0
10409,"高雄市","三民區立德里",4,3,1,1,0,1,1,0
10409,"高雄市","三民區立業里",1,0,1,3,3,0,0,0
10409,"高雄市","三民區民享里",1,1,0,3,1,2,3,1
10409,"高雄市","三民區千北里",3,2,1,1,0,1,3,0
10409,"高雄市","三民區千秋里",2,2,0,2,1,1,0,1
10409,"高雄市","三民區千歲里",0,0,0,3,2,1,3,1
10409,"高雄市","三民區十美里",3,1,2,3,3,0,3,0
10409,"高雄市","三民區十全里",3,3,0,3,2,1,4,1
10409,"高雄市","三民區同德里",2,0,2,2,2,0,2,2
10409,"高雄市","三民區灣愛里",6,2,4,4,3,1,3,2
10409,"高雄市","三民區灣成里",6,2,4,3,2,1,3,2
10409,"高雄市","三民區灣復里",11,9,2,1,1,0,2,3
10409,"高雄市","三民區灣華里",3,1,2,9,5,4,1,0
10409,"高雄市","三民區灣利里",6,6,0,3,1,2,3,1
10409,"高雄市","三民區灣勝里",4,2,2,1,1,0,2,1
10409,"高雄市","三民區灣興里",5,2,3,3,2,1,1,0
10409,"高雄市","三民區灣中里",17,11,6,8,3,5,4,3
10409,"高雄市","三民區灣子里",6,4,2,3,3,0,8,2
10409,"高雄市","三民區興德里",3,3,0,5,2,3,1,0
10409,"高雄市","三民區裕民里",1,0,1,1,0,1,1,0
10409,"高雄市","三民區長明里",2,2,0,2,1,1,2,0
10409,"高雄市","三民區正順里",2,1,1,11,5,6,3,1
10409,"高雄市","三民區正興里",20,12,8,17,9,8,13,6
10409,"高雄市","杉林區大愛里",6,1,5,4,2,2,3,1
10409,"高雄市","杉林區集來里",4,3,1,4,3,1,1,0
10409,"高雄市","杉林區木梓里",0,0,0,2,0,2,1,0
10409,"高雄市","杉林區杉林里",0,0,0,5,2,3,0,0
10409,"高雄市","杉林區上平里",1,1,0,3,3,0,1,1
10409,"高雄市","杉林區新庄里",1,1,0,3,2,1,3,2
10409,"高雄市","杉林區月眉里",3,0,3,5,2,3,1,1
10409,"高雄市","杉林區月美里",2,1,1,6,5,1,1,1
10409,"高雄市","桃源區寶山里",0,0,0,2,1,1,0,1
10409,"高雄市","桃源區復興里",0,0,0,0,0,0,0,0
10409,"高雄市","桃源區高中里",0,0,0,0,0,0,0,0
10409,"高雄市","桃源區建山里",4,2,2,2,2,0,0,0
10409,"高雄市","桃源區拉芙蘭里",1,0,1,1,1,0,0,0
10409,"高雄市","桃源區梅山里",1,1,0,0,0,0,0,0
10409,"高雄市","桃源區勤和里",2,0,2,1,1,0,1,1
10409,"高雄市","桃源區桃源里",2,1,1,1,0,1,1,1
10409,"高雄市","田寮區崇德里",6,5,1,2,1,1,0,1
10409,"高雄市","田寮區大同里",0,0,0,1,1,0,1,0
10409,"高雄市","田寮區古亭里",0,0,0,2,2,0,0,1
10409,"高雄市","田寮區鹿埔里",1,0,1,2,1,1,1,0
10409,"高雄市","田寮區南安里",1,1,0,3,1,2,2,0
10409,"高雄市","田寮區七星里",0,0,0,3,2,1,1,0
10409,"高雄市","田寮區三和里",0,0,0,1,0,1,1,0
10409,"高雄市","田寮區田寮里",0,0,0,1,1,0,0,0
10409,"高雄市","田寮區西德里",1,0,1,3,3,0,0,0
10409,"高雄市","田寮區新興里",0,0,0,5,4,1,1,0
10409,"高雄市","小港區大苓里",5,1,4,2,1,1,4,1
10409,"高雄市","小港區大坪里",6,3,3,1,0,1,0,1
10409,"高雄市","小港區店鎮里",12,7,5,9,6,3,8,1
10409,"高雄市","小港區二苓里",8,4,4,8,6,2,4,2
10409,"高雄市","小港區鳳宮里",3,2,1,0,0,0,3,1
10409,"高雄市","小港區鳳林里",7,3,4,5,3,2,2,0
10409,"高雄市","小港區鳳鳴里",5,4,1,4,1,3,2,1
10409,"高雄市","小港區鳳森里",5,1,4,1,1,0,1,0
10409,"高雄市","小港區鳳興里",4,3,1,2,1,1,4,2
10409,"高雄市","小港區鳳源里",7,4,3,5,3,2,9,1
10409,"高雄市","小港區港后里",3,1,2,0,0,0,3,0
10409,"高雄市","小港區港口里",2,2,0,4,4,0,7,0
10409,"高雄市","小港區港明里",9,4,5,5,3,2,4,1
10409,"高雄市","小港區港南里",5,4,1,9,6,3,5,0
10409,"高雄市","小港區港墘里",2,1,1,1,1,0,4,1
10409,"高雄市","小港區港興里",8,3,5,3,2,1,3,0
10409,"高雄市","小港區港正里",5,2,3,1,1,0,2,0
10409,"高雄市","小港區高松里",3,1,2,1,0,1,5,1
10409,"高雄市","小港區桂林里",11,5,6,13,9,4,15,6
10409,"高雄市","小港區合作里",4,2,2,2,2,0,4,4
10409,"高雄市","小港區宏亮里",4,2,2,5,2,3,6,1
10409,"高雄市","小港區濟南里",5,4,1,6,1,5,2,0
10409,"高雄市","小港區孔宅里",5,0,5,3,3,0,4,3
10409,"高雄市","小港區六苓里",5,3,2,3,0,3,5,2
10409,"高雄市","小港區龍鳳里",2,1,1,7,3,4,3,1
10409,"高雄市","小港區坪頂里",14,10,4,6,3,3,14,4
10409,"高雄市","小港區青島里",3,0,3,7,4,3,3,1
10409,"高雄市","小港區三苓里",5,3,2,4,1,3,3,3
10409,"高雄市","小港區廈莊里",5,2,3,5,2,3,6,1
10409,"高雄市","小港區山東里",4,4,0,4,4,0,4,2
10409,"高雄市","小港區山明里",21,9,12,13,9,4,11,6
10409,"高雄市","小港區順苓里",9,4,5,2,1,1,14,2
10409,"高雄市","小港區松金里",2,0,2,0,0,0,4,1
10409,"高雄市","小港區松山里",13,7,6,2,1,1,3,1
10409,"高雄市","小港區泰山里",9,4,5,3,2,1,3,3
10409,"高雄市","小港區小港里",0,0,0,6,6,0,1,0
10409,"高雄市","小港區正苓里",8,4,4,1,0,1,4,2
10409,"高雄市","小港區中厝里",6,3,3,6,3,3,5,1
10409,"高雄市","新興區愛平里",2,1,1,5,1,4,1,3
10409,"高雄市","新興區成功里",1,1,0,2,1,1,1,1
10409,"高雄市","新興區大明里",4,2,2,0,0,0,1,0
10409,"高雄市","新興區德生里",5,3,2,2,2,0,3,3
10409,"高雄市","新興區德望里",4,3,1,4,4,0,2,0
10409,"高雄市","新興區德政里",0,0,0,0,0,0,0,1
10409,"高雄市","新興區東坡里",1,0,1,5,2,3,3,0
10409,"高雄市","新興區光耀里",6,3,3,3,3,0,6,2
10409,"高雄市","新興區漢民里",0,0,0,0,0,0,2,0
10409,"高雄市","新興區浩然里",3,1,2,3,2,1,1,0
10409,"高雄市","新興區華聲里",0,0,0,0,0,0,2,0
10409,"高雄市","新興區建華里",0,0,0,2,0,2,1,0
10409,"高雄市","新興區建興里",1,1,0,2,0,2,0,1
10409,"高雄市","新興區蕉園里",0,0,0,1,1,0,3,0
10409,"高雄市","新興區開平里",6,3,3,8,3,5,4,0
10409,"高雄市","新興區黎明里",2,2,0,3,2,1,1,1
10409,"高雄市","新興區明莊里",0,0,0,1,0,1,0,0
10409,"高雄市","新興區南港里",5,2,3,1,0,1,4,0
10409,"高雄市","新興區秋山里",0,0,0,1,1,0,1,1
10409,"高雄市","新興區仁聲里",1,1,0,1,0,1,0,0
10409,"高雄市","新興區榮治里",2,1,1,2,0,2,1,0
10409,"高雄市","新興區順昌里",4,2,2,2,1,1,1,1
10409,"高雄市","新興區文昌里",3,2,1,1,0,1,1,0
10409,"高雄市","新興區新江里",2,0,2,2,1,1,2,0
10409,"高雄市","新興區興昌里",1,0,1,3,1,2,2,1
10409,"高雄市","新興區永寧里",1,1,0,3,3,0,2,1
10409,"高雄市","新興區玉衡里",0,0,0,3,1,2,3,1
10409,"高雄市","新興區長驛里",2,0,2,4,2,2,0,2
10409,"高雄市","新興區振成里",1,1,0,2,1,1,5,0
10409,"高雄市","新興區振華里",1,1,0,4,3,1,1,0
10409,"高雄市","新興區正氣里",5,3,2,1,1,0,0,0
10409,"高雄市","新興區中東里",4,1,3,8,5,3,4,4
10409,"高雄市","鹽埕區博愛里",0,0,0,0,0,0,0,0
10409,"高雄市","鹽埕區慈愛里",0,0,0,0,0,0,0,0
10409,"高雄市","鹽埕區府北里",2,0,2,5,4,1,3,0
10409,"高雄市","鹽埕區港都里",0,0,0,2,0,2,0,0
10409,"高雄市","鹽埕區光明里",1,0,1,3,2,1,0,1
10409,"高雄市","鹽埕區河濱里",1,0,1,1,0,1,0,1
10409,"高雄市","鹽埕區江南里",1,1,0,4,3,1,0,1
10409,"高雄市","鹽埕區江西里",0,0,0,1,1,0,2,1
10409,"高雄市","鹽埕區教仁里",1,1,0,5,3,2,1,0
10409,"高雄市","鹽埕區瀨南里",0,0,0,2,1,1,0,0
10409,"高雄市","鹽埕區藍橋里",2,1,1,4,3,1,4,1
10409,"高雄市","鹽埕區陸橋里",0,0,0,0,0,0,1,1
10409,"高雄市","鹽埕區南端里",3,1,2,2,0,2,0,1
10409,"高雄市","鹽埕區沙地里",1,0,1,1,1,0,0,2
10409,"高雄市","鹽埕區壽星里",0,0,0,3,2,1,2,2
10409,"高雄市","鹽埕區新豐里",4,1,3,1,0,1,2,0
10409,"高雄市","鹽埕區新化里",0,0,0,0,0,0,3,1
10409,"高雄市","鹽埕區新樂里",0,0,0,1,1,0,0,1
10409,"高雄市","鹽埕區育仁里",3,1,2,0,0,0,0,1
10409,"高雄市","鹽埕區中山里",2,1,1,4,3,1,0,0
10409,"高雄市","鹽埕區中原里",3,2,1,1,0,1,2,0
10409,"高雄市","燕巢區安招里",4,4,0,14,13,1,2,1
10409,"高雄市","燕巢區東燕里",4,2,2,3,2,1,2,0
10409,"高雄市","燕巢區鳳雄里",4,3,1,3,2,1,1,0
10409,"高雄市","燕巢區橫山里",2,0,2,5,2,3,2,1
10409,"高雄市","燕巢區尖山里",1,0,1,3,2,1,2,0
10409,"高雄市","燕巢區角宿里",6,3,3,0,0,0,10,1
10409,"高雄市","燕巢區金山里",2,0,2,0,0,0,0,0
10409,"高雄市","燕巢區南燕里",3,1,2,3,1,2,7,4
10409,"高雄市","燕巢區瓊林里",5,3,2,4,3,1,4,0
10409,"高雄市","燕巢區深水里",1,1,0,7,6,1,1,1
10409,"高雄市","燕巢區西燕里",7,5,2,4,3,1,2,0
10409,"高雄市","永安區保寧里",7,3,4,3,0,3,3,2
10409,"高雄市","永安區維新里",11,6,5,3,1,2,3,1
10409,"高雄市","永安區新港里",6,3,3,5,4,1,3,0
10409,"高雄市","永安區鹽田里",0,0,0,1,0,1,0,0
10409,"高雄市","永安區永安里",1,0,1,4,2,2,0,0
10409,"高雄市","永安區永華里",4,2,2,3,2,1,1,0
10409,"高雄市","梓官區赤東里",2,0,2,5,2,3,1,3
10409,"高雄市","梓官區赤崁里",2,0,2,3,2,1,2,0
10409,"高雄市","梓官區赤西里",1,0,1,2,2,0,1,1
10409,"高雄市","梓官區大舍里",3,2,1,7,7,0,7,2
10409,"高雄市","梓官區典寶里",6,4,2,4,3,1,3,0
10409,"高雄市","梓官區茄苳里",5,3,2,6,2,4,0,2
10409,"高雄市","梓官區禮蚵里",1,0,1,1,0,1,2,0
10409,"高雄市","梓官區同安里",0,0,0,1,1,0,2,0
10409,"高雄市","梓官區信蚵里",4,1,3,4,2,2,4,1
10409,"高雄市","梓官區智蚵里",7,5,2,6,2,4,7,2
10409,"高雄市","梓官區中崙里",2,0,2,3,0,3,1,1
10409,"高雄市","梓官區梓和里",2,1,1,7,5,2,2,1
10409,"高雄市","梓官區梓平里",2,1,1,2,2,0,1,0
10409,"高雄市","梓官區梓信里",2,2,0,3,1,2,1,1
10409,"高雄市","梓官區梓義里",3,2,1,5,4,1,0,1
10409,"高雄市","左營區菜公里",55,33,22,21,11,10,27,16
10409,"高雄市","左營區城南里",0,0,0,0,0,0,1,0
10409,"高雄市","左營區崇實里",16,9,7,1,1,0,9,3
10409,"高雄市","左營區頂北里",0,0,0,0,0,0,1,0
10409,"高雄市","左營區頂西里",1,1,0,2,2,0,2,1
10409,"高雄市","左營區福山里",61,33,28,23,16,7,48,15
10409,"高雄市","左營區光輝里",2,2,0,2,1,1,3,2
10409,"高雄市","左營區果峰里",0,0,0,6,4,2,2,0
10409,"高雄市","左營區果惠里",1,0,1,5,2,3,2,1
10409,"高雄市","左營區果貿里",8,3,5,11,7,4,1,4
10409,"高雄市","左營區海勝里",6,2,4,16,11,5,3,3
10409,"高雄市","左營區合群里",2,1,1,7,4,3,2,0
10409,"高雄市","左營區進學里",0,0,0,2,2,0,1,1
10409,"高雄市","左營區莒光里",3,0,3,9,5,4,1,1
10409,"高雄市","左營區路東里",4,2,2,0,0,0,1,1
10409,"高雄市","左營區廟北里",0,0,0,2,0,2,1,0
10409,"高雄市","左營區廟東里",0,0,0,2,1,1,3,0
10409,"高雄市","左營區明建里",4,3,1,1,1,0,3,0
10409,"高雄市","左營區埤北里",0,0,0,6,4,2,2,3
10409,"高雄市","左營區埤東里",3,3,0,1,0,1,0,0
10409,"高雄市","左營區埤西里",0,0,0,0,0,0,1,1
10409,"高雄市","左營區屏山里",0,0,0,6,4,2,0,1
10409,"高雄市","左營區廍北里",0,0,0,0,0,0,1,0
10409,"高雄市","左營區廍南里",0,0,0,1,0,1,0,0
10409,"高雄市","左營區聖后里",1,0,1,3,3,0,0,0
10409,"高雄市","左營區聖南里",0,0,0,1,0,1,1,0
10409,"高雄市","左營區聖西里",0,0,0,1,1,0,0,0
10409,"高雄市","左營區尾北里",2,0,2,5,3,2,2,3
10409,"高雄市","左營區尾南里",1,1,0,4,2,2,0,0
10409,"高雄市","左營區尾西里",2,2,0,2,1,1,0,0
10409,"高雄市","左營區祥和里",1,1,0,1,1,0,1,1
10409,"高雄市","左營區新光里",18,7,11,7,5,2,21,4
10409,"高雄市","左營區新上里",48,20,28,17,10,7,33,11
10409,"高雄市","左營區新下里",20,12,8,6,3,3,15,6
10409,"高雄市","左營區新中里",4,2,2,8,5,3,4,1
10409,"高雄市","左營區永清里",5,3,2,1,1,0,4,3
10409,"高雄市","左營區中北里",2,2,0,3,1,2,1,1
10409,"高雄市","左營區中南里",0,0,0,0,0,0,1,0
10409,"高雄市","左營區自助里",1,1,0,2,1,1,1,2
10411,"高雄市","阿蓮區阿蓮里",11,6,5,12,5,7,4,5
10411,"高雄市","阿蓮區峯山里",0,0,0,4,3,1,0,0
10411,"高雄市","阿蓮區復安里",0,0,0,4,4,0,3,2
10411,"高雄市","阿蓮區崗山里",1,0,1,4,2,2,0,0
10411,"高雄市","阿蓮區港後里",4,2,2,5,2,3,4,0
10411,"高雄市","阿蓮區和蓮里",4,3,1,3,3,0,5,1
10411,"高雄市","阿蓮區南蓮里",1,0,1,3,3,0,10,3
10411,"高雄市","阿蓮區青旗里",2,2,0,7,4,3,1,1
10411,"高雄市","阿蓮區清蓮里",5,4,1,2,1,1,4,2
10411,"高雄市","阿蓮區石安里",1,1,0,2,2,0,3,1
10411,"高雄市","阿蓮區玉庫里",1,0,1,3,2,1,0,0
10411,"高雄市","阿蓮區中路里",5,3,2,4,3,1,1,1
10411,"高雄市","大寮區潮寮里",5,3,2,9,7,2,9,1
10411,"高雄市","大寮區大寮里",17,9,8,9,9,0,13,4
10411,"高雄市","大寮區光武里",1,0,1,0,0,0,0,0
10411,"高雄市","大寮區過溪里",6,5,1,7,5,2,6,0
10411,"高雄市","大寮區後庄里",10,5,5,9,8,1,6,7
10411,"高雄市","大寮區會結里",3,2,1,0,0,0,2,0
10411,"高雄市","大寮區會社里",6,3,3,17,7,10,9,5
10411,"高雄市","大寮區江山里",3,2,1,1,1,0,3,2
10411,"高雄市","大寮區拷潭里",3,1,2,2,2,0,2,2
10411,"高雄市","大寮區琉球里",5,3,2,4,3,1,6,0
10411,"高雄市","大寮區內坑里",16,11,5,13,8,5,8,5
10411,"高雄市","大寮區前庄里",2,2,0,2,2,0,1,2
10411,"高雄市","大寮區三隆里",10,3,7,5,3,2,8,4
10411,"高雄市","大寮區山頂里",10,4,6,11,11,0,10,4
10411,"高雄市","大寮區上寮里",6,3,3,1,1,0,3,0
10411,"高雄市","大寮區翁園里",4,3,1,3,2,1,5,5
10411,"高雄市","大寮區溪寮里",2,0,2,0,0,0,2,0
10411,"高雄市","大寮區新厝里",1,1,0,3,3,0,4,0
10411,"高雄市","大寮區義和里",1,0,1,5,3,2,5,2
10411,"高雄市","大寮區義仁里",2,1,1,2,1,1,3,0
10411,"高雄市","大寮區永芳里",10,4,6,14,3,11,11,3
10411,"高雄市","大寮區昭明里",5,5,0,8,7,1,2,4
10411,"高雄市","大寮區中興里",16,10,6,9,5,4,10,5
10411,"高雄市","大寮區中庄里",23,13,10,14,10,4,13,4
10411,"高雄市","大寮區忠義里",0,0,0,1,1,0,1,0
10411,"高雄市","大社區保安里",6,0,6,3,2,1,5,1
10411,"高雄市","大社區保社里",5,1,4,3,3,0,6,3
10411,"高雄市","大社區翠屏里",3,0,3,4,3,1,1,1
10411,"高雄市","大社區大社里",13,8,5,10,6,4,8,2
10411,"高雄市","大社區觀音里",7,5,2,5,5,0,7,3
10411,"高雄市","大社區嘉誠里",1,0,1,2,2,0,0,0
10411,"高雄市","大社區三奶里",2,0,2,3,2,1,2,2
10411,"高雄市","大社區神農里",8,5,3,8,6,2,5,0
10411,"高雄市","大社區中里里",5,2,3,9,5,4,9,3
10411,"高雄市","大樹區大坑里",6,1,5,1,1,0,2,0
10411,"高雄市","大樹區大樹里",4,2,2,4,2,2,4,2
10411,"高雄市","大樹區姑山里",1,0,1,3,1,2,4,0
10411,"高雄市","大樹區和山里",0,0,0,0,0,0,0,0
10411,"高雄市","大樹區井腳里",1,1,0,4,3,1,1,0
10411,"高雄市","大樹區九曲里",8,6,2,4,3,1,4,1
10411,"高雄市","大樹區久堂里",4,2,2,9,6,3,9,3
10411,"高雄市","大樹區龍目里",2,0,2,3,2,1,1,1
10411,"高雄市","大樹區三和里",1,1,0,2,1,1,1,0
10411,"高雄市","大樹區檨腳里",9,6,3,4,2,2,4,0
10411,"高雄市","大樹區水安里",5,3,2,2,0,2,0,1
10411,"高雄市","大樹區水寮里",7,5,2,3,1,2,3,1
10411,"高雄市","大樹區統嶺里",2,1,1,2,2,0,1,0
10411,"高雄市","大樹區溪埔里",1,1,0,4,2,2,2,1
10411,"高雄市","大樹區小坪里",3,0,3,4,2,2,0,0
10411,"高雄市","大樹區興山里",0,0,0,3,3,0,1,1
10411,"高雄市","大樹區興田里",4,1,3,4,2,2,3,0
10411,"高雄市","大樹區竹寮里",7,1,6,2,0,2,3,1
10411,"高雄市","鳳山區保安里",20,11,9,4,1,3,13,2
10411,"高雄市","鳳山區北門里",7,4,3,6,5,1,10,3
10411,"高雄市","鳳山區曹公里",3,2,1,4,3,1,5,0
10411,"高雄市","鳳山區成功里",4,1,3,0,0,0,1,1
10411,"高雄市","鳳山區誠德里",0,0,0,3,1,2,4,1
10411,"高雄市","鳳山區誠信里",2,1,1,7,6,1,3,1
10411,"高雄市","鳳山區誠義里",7,3,4,4,2,2,7,3
10411,"高雄市","鳳山區誠智里",2,1,1,5,4,1,3,1
10411,"高雄市","鳳山區大德里",8,5,3,6,3,3,8,1
10411,"高雄市","鳳山區東門里",12,6,6,12,8,4,10,4
10411,"高雄市","鳳山區二甲里",4,0,4,4,4,0,6,3
10411,"高雄市","鳳山區鳳東里",14,7,7,6,3,3,8,1
10411,"高雄市","鳳山區鳳崗里",1,0,1,3,1,2,2,1
10411,"高雄市","鳳山區福誠里",11,8,3,5,1,4,12,2
10411,"高雄市","鳳山區福祥里",6,4,2,1,1,0,5,2
10411,"高雄市","鳳山區福興里",11,9,2,15,6,9,11,4
10411,"高雄市","鳳山區富甲里",3,3,0,3,2,1,1,1
10411,"高雄市","鳳山區富榮里",5,0,5,4,3,1,6,1
10411,"高雄市","鳳山區光明里",3,2,1,0,0,0,2,1
10411,"高雄市","鳳山區國富里",2,1,1,1,1,0,3,1
10411,"高雄市","鳳山區國光里",4,1,3,4,2,2,10,0
10411,"高雄市","鳳山區國隆里",4,2,2,5,3,2,11,1
10411,"高雄市","鳳山區國泰里",4,2,2,6,2,4,3,2
10411,"高雄市","鳳山區過埤里",47,19,28,7,2,5,31,10
10411,"高雄市","鳳山區海光里",5,3,2,9,6,3,6,3
10411,"高雄市","鳳山區海洋里",5,3,2,2,1,1,5,2
10411,"高雄市","鳳山區和德里",3,2,1,4,3,1,2,1
10411,"高雄市","鳳山區和興里",6,4,2,8,6,2,3,1
10411,"高雄市","鳳山區老爺里",17,8,9,3,2,1,8,5
10411,"高雄市","鳳山區龍成里",4,1,3,3,1,2,4,0
10411,"高雄市","鳳山區南成里",21,11,10,8,3,5,8,2
10411,"高雄市","鳳山區南和里",4,3,1,5,2,3,3,4
10411,"高雄市","鳳山區南興里",1,1,0,2,2,0,1,0
10411,"高雄市","鳳山區埤頂里",17,11,6,5,3,2,9,6
10411,"高雄市","鳳山區瑞興里",13,5,8,8,6,2,8,0
10411,"高雄市","鳳山區瑞竹里",4,3,1,6,5,1,6,0
10411,"高雄市","鳳山區三民里",1,1,0,0,0,0,2,0
10411,"高雄市","鳳山區善美里",10,6,4,7,2,5,9,2
10411,"高雄市","鳳山區生明里",2,2,0,4,1,3,2,0
10411,"高雄市","鳳山區天興里",9,4,5,11,3,8,10,3
10411,"高雄市","鳳山區文德里",20,8,12,10,5,5,12,1
10411,"高雄市","鳳山區文福里",22,10,12,9,6,3,11,6
10411,"高雄市","鳳山區文衡里",8,6,2,2,1,1,11,0
10411,"高雄市","鳳山區文華里",15,10,5,10,8,2,13,2
10411,"高雄市","鳳山區文山里",11,4,7,1,1,0,9,4
10411,"高雄市","鳳山區文英里",8,3,5,3,2,1,6,1
10411,"高雄市","鳳山區五福里",6,2,4,3,0,3,3,2
10411,"高雄市","鳳山區武漢里",12,4,8,6,5,1,5,3
10411,"高雄市","鳳山區武慶里",2,2,0,5,4,1,5,2
10411,"高雄市","鳳山區武松里",4,0,4,7,2,5,5,2
10411,"高雄市","鳳山區縣口里",1,0,1,0,0,0,1,0
10411,"高雄市","鳳山區縣衙里",1,0,1,1,0,1,2,0
10411,"高雄市","鳳山區協和里",8,5,3,1,0,1,5,1
10411,"高雄市","鳳山區新富里",10,7,3,5,2,3,5,2
10411,"高雄市","鳳山區新甲里",5,3,2,6,3,3,7,1
10411,"高雄市","鳳山區新樂里",2,1,1,2,1,1,4,4
10411,"高雄市","鳳山區新強里",13,9,4,8,3,5,8,2
10411,"高雄市","鳳山區新泰里",11,6,5,4,3,1,10,3
10411,"高雄市","鳳山區新武里",3,1,2,2,2,0,4,2
10411,"高雄市","鳳山區新興里",1,0,1,6,5,1,1,3
10411,"高雄市","鳳山區興仁里",4,1,3,7,5,2,8,3
10411,"高雄市","鳳山區興中里",1,1,0,2,1,1,0,0
10411,"高雄市","鳳山區一甲里",4,3,1,8,7,1,6,2
10411,"高雄市","鳳山區鎮北里",23,12,11,5,2,3,21,6
10411,"高雄市","鳳山區鎮東里",3,1,2,1,0,1,3,0
10411,"高雄市","鳳山區鎮南里",5,1,4,6,4,2,17,1
10411,"高雄市","鳳山區鎮西里",7,4,3,8,5,3,5,2
10411,"高雄市","鳳山區正義里",14,10,4,6,3,3,6,2
10411,"高雄市","鳳山區中和里",9,3,6,6,4,2,6,0
10411,"高雄市","鳳山區中崙里",5,1,4,1,1,0,4,0
10411,"高雄市","鳳山區中民里",14,8,6,2,1,1,8,1
10411,"高雄市","鳳山區中榮里",8,8,0,4,4,0,3,0
10411,"高雄市","鳳山區中正里",4,0,4,9,7,2,6,3
10411,"高雄市","鳳山區忠誠里",9,3,6,5,4,1,9,2
10411,"高雄市","鳳山區忠孝里",14,5,9,10,5,5,11,0
10411,"高雄市","鳳山區忠義里",13,5,8,8,2,6,9,4
10411,"高雄市","岡山區白米里",4,2,2,4,4,0,3,2
10411,"高雄市","岡山區本洲里",1,0,1,3,1,2,2,1
10411,"高雄市","岡山區碧紅里",8,3,5,3,0,3,6,3
10411,"高雄市","岡山區程香里",5,3,2,2,1,1,4,2
10411,"高雄市","岡山區大遼里",1,1,0,4,3,1,2,0
10411,"高雄市","岡山區大莊里",4,3,1,0,0,0,1,0
10411,"高雄市","岡山區福興里",3,1,2,4,3,1,1,1
10411,"高雄市","岡山區岡山里",10,5,5,6,5,1,3,4
10411,"高雄市","岡山區和平里",1,1,0,0,0,0,0,0
10411,"高雄市","岡山區後紅里",6,4,2,7,5,2,5,2
10411,"高雄市","岡山區後協里",9,6,3,5,2,3,9,3
10411,"高雄市","岡山區華崗里",4,2,2,1,1,0,5,0
10411,"高雄市","岡山區嘉峰里",2,1,1,4,3,1,2,0
10411,"高雄市","岡山區嘉興里",5,2,3,3,2,1,3,1
10411,"高雄市","岡山區劉厝里",0,0,0,3,2,1,2,1
10411,"高雄市","岡山區平安里",1,0,1,4,4,0,2,0
10411,"高雄市","岡山區前峰里",4,4,0,3,3,0,4,1
10411,"高雄市","岡山區仁壽里",8,6,2,5,5,0,4,2
10411,"高雄市","岡山區仁義里",1,0,1,6,6,0,3,2
10411,"高雄市","岡山區三和里",1,0,1,2,1,1,0,2
10411,"高雄市","岡山區石潭里",3,2,1,0,0,0,4,1
10411,"高雄市","岡山區壽峰里",4,4,0,3,2,1,4,1
10411,"高雄市","岡山區壽天里",7,4,3,4,1,3,3,2
10411,"高雄市","岡山區台上里",13,10,3,3,1,2,6,2
10411,"高雄市","岡山區潭底里",1,1,0,2,2,0,0,1
10411,"高雄市","岡山區灣裡里",8,5,3,2,1,1,2,2
10411,"高雄市","岡山區維仁里",1,0,1,1,0,1,1,1
10411,"高雄市","岡山區為隨里",2,0,2,0,0,0,2,0
10411,"高雄市","岡山區協和里",5,5,0,1,0,1,5,3
10411,"高雄市","岡山區協榮里",1,0,1,1,0,1,2,1
10411,"高雄市","岡山區信義里",6,3,3,3,3,0,1,0
10411,"高雄市","岡山區忠孝里",3,1,2,12,7,5,2,3
10411,"高雄市","岡山區竹圍里",15,9,6,8,2,6,8,5
10411,"高雄市","鼓山區寶樹里",1,1,0,5,5,0,2,1
10411,"高雄市","鼓山區登山里",0,0,0,1,1,0,1,1
10411,"高雄市","鼓山區峰南里",0,0,0,1,1,0,1,0
10411,"高雄市","鼓山區鼓峰里",1,0,1,0,0,0,2,0
10411,"高雄市","鼓山區鼓岩里",2,0,2,2,0,2,0,3
10411,"高雄市","鼓山區光化里",0,0,0,2,1,1,4,0
10411,"高雄市","鼓山區光榮里",6,1,5,12,5,7,5,5
10411,"高雄市","鼓山區河邊里",0,0,0,2,2,0,2,0
10411,"高雄市","鼓山區厚生里",7,2,5,6,5,1,3,3
10411,"高雄市","鼓山區華豐里",6,2,4,6,5,1,6,0
10411,"高雄市","鼓山區惠安里",3,3,0,3,3,0,4,0
10411,"高雄市","鼓山區建國里",2,1,1,2,1,1,0,3
10411,"高雄市","鼓山區麗興里",0,0,0,2,2,0,2,1
10411,"高雄市","鼓山區龍井里",1,0,1,1,0,1,0,3
10411,"高雄市","鼓山區龍水里",54,33,21,10,6,4,42,14
10411,"高雄市","鼓山區龍子里",38,16,22,7,5,2,26,8
10411,"高雄市","鼓山區綠川里",8,4,4,2,1,1,4,1
10411,"高雄市","鼓山區民強里",1,1,0,5,4,1,4,0
10411,"高雄市","鼓山區民族里",2,1,1,5,4,1,3,1
10411,"高雄市","鼓山區明誠里",36,22,14,16,9,7,23,11
10411,"高雄市","鼓山區內惟里",3,2,1,1,1,0,2,0
10411,"高雄市","鼓山區平和里",11,3,8,1,1,0,5,2
10411,"高雄市","鼓山區前峰里",4,3,1,7,7,0,8,2
10411,"高雄市","鼓山區山下里",2,0,2,3,3,0,2,0
10411,"高雄市","鼓山區哨船頭里",0,0,0,1,0,1,3,0
10411,"高雄市","鼓山區壽山里",2,1,1,2,1,1,1,2
10411,"高雄市","鼓山區樹德里",1,1,0,5,4,1,0,0
10411,"高雄市","鼓山區桃源里",0,0,0,0,0,0,1,1
10411,"高雄市","鼓山區維生里",6,2,4,5,3,2,3,0
10411,"高雄市","鼓山區新民里",2,1,1,2,0,2,2,0
10411,"高雄市","鼓山區興宗里",0,0,0,3,2,1,2,1
10411,"高雄市","鼓山區雄峰里",1,1,0,3,1,2,1,0
10411,"高雄市","鼓山區延平里",2,1,1,4,2,2,1,0
10411,"高雄市","鼓山區裕豐里",2,0,2,2,0,2,1,1
10411,"高雄市","鼓山區裕興里",5,2,3,7,5,2,2,1
10411,"高雄市","鼓山區正德里",1,1,0,4,2,2,1,1
10411,"高雄市","鼓山區忠正里",3,2,1,9,5,4,7,1
10411,"高雄市","鼓山區自強里",0,0,0,4,4,0,0,0
10411,"高雄市","湖內區大湖里",5,3,2,6,5,1,6,4
10411,"高雄市","湖內區公舘里",6,2,4,2,1,1,3,0
10411,"高雄市","湖內區海埔里",2,2,0,5,3,2,0,0
10411,"高雄市","湖內區海山里",2,1,1,4,1,3,1,0
10411,"高雄市","湖內區湖東里",7,4,3,1,1,0,5,2
10411,"高雄市","湖內區湖內里",6,2,4,4,2,2,10,1
10411,"高雄市","湖內區劉家里",0,0,0,1,0,1,2,0
10411,"高雄市","湖內區太爺里",2,0,2,0,0,0,1,0
10411,"高雄市","湖內區田尾里",3,1,2,3,2,1,2,1
10411,"高雄市","湖內區文賢里",2,1,1,4,0,4,0,3
10411,"高雄市","湖內區葉厝里",7,2,5,3,0,3,5,0
10411,"高雄市","湖內區逸賢里",3,2,1,0,0,0,1,0
10411,"高雄市","湖內區中賢里",5,1,4,2,0,2,1,1
10411,"高雄市","湖內區忠興里",2,1,1,1,1,0,0,1
10411,"高雄市","茄萣區白雲里",1,1,0,1,0,1,2,0
10411,"高雄市","茄萣區保定里",3,2,1,1,0,1,4,0
10411,"高雄市","茄萣區大定里",2,2,0,4,2,2,1,0
10411,"高雄市","茄萣區福德里",0,0,0,1,1,0,1,2
10411,"高雄市","茄萣區光定里",1,1,0,2,1,1,2,0
10411,"高雄市","茄萣區和協里",1,0,1,5,3,2,3,0
10411,"高雄市","茄萣區吉定里",1,0,1,1,1,0,2,0
10411,"高雄市","茄萣區嘉安里",4,3,1,2,1,1,3,0
10411,"高雄市","茄萣區嘉賜里",10,5,5,1,1,0,8,1
10411,"高雄市","茄萣區嘉定里",1,1,0,4,1,3,4,1
10411,"高雄市","茄萣區嘉福里",4,3,1,3,3,0,1,1
10411,"高雄市","茄萣區嘉樂里",2,2,0,2,1,1,1,0
10411,"高雄市","茄萣區嘉泰里",1,0,1,7,6,1,2,1
10411,"高雄市","茄萣區崎漏里",10,1,9,7,4,3,6,4
10411,"高雄市","茄萣區萬福里",1,1,0,2,0,2,1,0
10411,"高雄市","甲仙區寶隆里",2,1,1,4,4,0,2,0
10411,"高雄市","甲仙區大田里",1,1,0,1,1,0,2,0
10411,"高雄市","甲仙區東安里",0,0,0,0,0,0,0,0
10411,"高雄市","甲仙區關山里",0,0,0,1,1,0,0,0
10411,"高雄市","甲仙區和安里",3,3,0,1,1,0,0,0
10411,"高雄市","甲仙區西安里",2,2,0,0,0,0,2,0
10411,"高雄市","甲仙區小林里",0,0,0,1,0,1,1,0
10411,"高雄市","林園區北汕里",2,0,2,4,2,2,2,2
10411,"高雄市","林園區頂厝里",16,6,10,6,4,2,8,1
10411,"高雄市","林園區東林里",3,2,1,3,1,2,9,0
10411,"高雄市","林園區東汕里",0,0,0,1,1,0,1,0
10411,"高雄市","林園區鳳芸里",3,1,2,2,1,1,2,1
10411,"高雄市","林園區港埔里",2,2,0,2,0,2,2,0
10411,"高雄市","林園區港嘴里",3,1,2,3,3,0,2,1
10411,"高雄市","林園區龔厝里",6,2,4,0,0,0,7,0
10411,"高雄市","林園區廣應里",11,8,3,5,1,4,13,2
10411,"高雄市","林園區林家里",1,0,1,4,2,2,1,0
10411,"高雄市","林園區林內里",2,2,0,3,2,1,1,1
10411,"高雄市","林園區林園里",4,0,4,3,3,0,9,1
10411,"高雄市","林園區仁愛里",8,3,5,7,6,1,4,1
10411,"高雄市","林園區潭頭里",6,4,2,5,3,2,2,1
10411,"高雄市","林園區王公里",7,6,1,3,2,1,3,3
10411,"高雄市","林園區文賢里",4,3,1,4,4,0,3,0
10411,"高雄市","林園區五福里",6,3,3,7,4,3,2,2
10411,"高雄市","林園區溪州里",4,1,3,4,4,0,5,1
10411,"高雄市","林園區西汕里",1,1,0,0,0,0,0,0
10411,"高雄市","林園區西溪里",8,5,3,4,2,2,7,2
10411,"高雄市","林園區中厝里",3,0,3,7,4,3,3,2
10411,"高雄市","林園區中門里",8,1,7,6,4,2,2,1
10411,"高雄市","林園區中汕里",4,3,1,5,3,2,2,2
10411,"高雄市","林園區中芸里",2,2,0,4,3,1,3,2
10411,"高雄市","苓雅區安祥里",1,1,0,2,2,0,3,0
10411,"高雄市","苓雅區博仁里",0,0,0,3,1,2,1,0
10411,"高雄市","苓雅區朝陽里",5,2,3,0,0,0,2,0
10411,"高雄市","苓雅區城北里",1,0,1,4,2,2,2,0
10411,"高雄市","苓雅區城東里",3,1,2,0,0,0,2,0
10411,"高雄市","苓雅區城西里",2,1,1,2,1,1,1,0
10411,"高雄市","苓雅區福地里",3,2,1,5,3,2,6,0
10411,"高雄市","苓雅區福東里",2,1,1,3,2,1,6,1
10411,"高雄市","苓雅區福海里",1,0,1,3,2,1,1,1
10411,"高雄市","苓雅區福居里",8,3,5,9,5,4,4,3
10411,"高雄市","苓雅區福康里",2,1,1,7,4,3,5,0
10411,"高雄市","苓雅區福隆里",3,2,1,0,0,0,0,0
10411,"高雄市","苓雅區福南里",1,1,0,7,3,4,0,0
10411,"高雄市","苓雅區福人里",0,0,0,4,2,2,2,0
10411,"高雄市","苓雅區福壽里",1,1,0,2,1,1,1,0
10411,"高雄市","苓雅區福西里",2,1,1,2,2,0,4,0
10411,"高雄市","苓雅區福祥里",3,1,2,0,0,0,1,1
10411,"高雄市","苓雅區鼓中里",2,2,0,6,2,4,3,0
10411,"高雄市","苓雅區光華里",1,1,0,2,0,2,1,0
10411,"高雄市","苓雅區廣澤里",1,0,1,4,4,0,2,0
10411,"高雄市","苓雅區和煦里",3,2,1,2,1,1,3,1
10411,"高雄市","苓雅區華堂里",5,4,1,5,3,2,4,1
10411,"高雄市","苓雅區建軍里",3,2,1,1,1,0,5,0
10411,"高雄市","苓雅區凱旋里",0,0,0,3,1,2,2,2
10411,"高雄市","苓雅區林安里",2,1,1,3,3,0,2,0
10411,"高雄市","苓雅區林德里",1,0,1,3,3,0,2,1
10411,"高雄市","苓雅區林富里",3,1,2,3,3,0,3,2
10411,"高雄市","苓雅區林貴里",5,4,1,4,3,1,3,0
10411,"高雄市","苓雅區林華里",2,2,0,5,3,2,2,2
10411,"高雄市","苓雅區林靖里",1,1,0,1,1,0,2,1
10411,"高雄市","苓雅區林南里",5,3,2,2,2,0,6,1
10411,"高雄市","苓雅區林泉里",4,1,3,1,1,0,1,1
10411,"高雄市","苓雅區林榮里",9,3,6,5,3,2,4,0
10411,"高雄市","苓雅區林圍里",1,1,0,1,1,0,3,2
10411,"高雄市","苓雅區林西里",2,0,2,2,1,1,0,0
10411,"高雄市","苓雅區林興里",2,2,0,0,0,0,0,1
10411,"高雄市","苓雅區林中里",7,2,5,4,2,2,6,0
10411,"高雄市","苓雅區苓東里",2,0,2,1,1,0,4,2
10411,"高雄市","苓雅區苓昇里",2,2,0,5,2,3,2,2
10411,"高雄市","苓雅區苓雅里",1,1,0,4,3,1,1,1
10411,"高雄市","苓雅區苓中里",6,4,2,5,2,3,3,2
10411,"高雄市","苓雅區苓洲里",1,1,0,4,1,3,6,1
10411,"高雄市","苓雅區美田里",1,1,0,3,2,1,0,0
10411,"高雄市","苓雅區民主里",6,5,1,2,1,1,4,2
10411,"高雄市","苓雅區普天里",5,3,2,4,3,1,5,3
10411,"高雄市","苓雅區普照里",7,3,4,3,1,2,4,0
10411,"高雄市","苓雅區晴朗里",0,0,0,5,4,1,1,1
10411,"高雄市","苓雅區人和里",0,0,0,5,2,3,1,0
10411,"高雄市","苓雅區仁政里",0,0,0,4,3,1,1,0
10411,"高雄市","苓雅區日中里",1,1,0,4,1,3,3,0
10411,"高雄市","苓雅區尚義里",2,1,1,0,0,0,2,0
10411,"高雄市","苓雅區田西里",6,4,2,2,1,1,4,0
10411,"高雄市","苓雅區同慶里",2,1,1,2,1,1,0,1
10411,"高雄市","苓雅區衛武里",1,1,0,2,1,1,1,1
10411,"高雄市","苓雅區文昌里",5,1,4,4,2,2,3,4
10411,"高雄市","苓雅區五福里",7,3,4,8,5,3,6,0
10411,"高雄市","苓雅區五權里",2,2,0,3,1,2,7,2
10411,"高雄市","苓雅區意誠里",5,2,3,5,3,2,8,5
10411,"高雄市","苓雅區英明里",4,3,1,4,3,1,2,2
10411,"高雄市","苓雅區永康里",5,1,4,5,3,2,2,1
10411,"高雄市","苓雅區正大里",5,2,3,4,4,0,10,3
10411,"高雄市","苓雅區正道里",10,6,4,8,4,4,8,2
10411,"高雄市","苓雅區正仁里",1,0,1,0,0,0,6,2
10411,"高雄市","苓雅區正文里",3,2,1,3,1,2,4,1
10411,"高雄市","苓雅區正心里",6,2,4,6,3,3,3,1
10411,"高雄市","苓雅區正言里",1,0,1,4,4,0,3,1
10411,"高雄市","苓雅區正義里",4,2,2,1,1,0,7,0
10411,"高雄市","苓雅區中正里",4,2,2,3,1,2,8,0
10411,"高雄市","苓雅區奏捷里",1,1,0,4,2,2,2,1
10411,"高雄市","六龜區寶來里",2,1,1,3,1,2,0,0
10411,"高雄市","六龜區大津里",0,0,0,0,0,0,0,0
10411,"高雄市","六龜區荖濃里",3,1,2,7,6,1,2,0
10411,"高雄市","六龜區六龜里",0,0,0,4,2,2,3,2
10411,"高雄市","六龜區文武里",0,0,0,6,3,3,1,2
10411,"高雄市","六龜區新發里",1,1,0,2,2,0,0,1
10411,"高雄市","六龜區新寮里",1,1,0,3,1,2,1,0
10411,"高雄市","六龜區新威里",0,0,0,2,0,2,0,0
10411,"高雄市","六龜區新興里",1,1,0,3,2,1,1,0
10411,"高雄市","六龜區興龍里",1,1,0,4,2,2,0,0
10411,"高雄市","六龜區義寶里",1,1,0,2,1,1,1,0
10411,"高雄市","六龜區中興里",2,0,2,0,0,0,1,2
10411,"高雄市","路竹區北嶺里",1,1,0,3,1,2,0,0
10411,"高雄市","路竹區頂寮里",3,1,2,3,3,0,1,0
10411,"高雄市","路竹區後鄉里",2,0,2,2,1,1,1,1
10411,"高雄市","路竹區甲北里",7,3,4,4,3,1,2,1
10411,"高雄市","路竹區甲南里",4,2,2,7,6,1,4,0
10411,"高雄市","路竹區三爺里",2,2,0,3,1,2,0,0
10411,"高雄市","路竹區社東里",0,0,0,3,1,2,3,0
10411,"高雄市","路竹區社南里",7,3,4,1,1,0,4,1
10411,"高雄市","路竹區社西里",5,3,2,5,3,2,5,0
10411,"高雄市","路竹區社中里",0,0,0,3,2,1,0,2
10411,"高雄市","路竹區文北里",5,3,2,5,1,4,1,1
10411,"高雄市","路竹區文南里",4,2,2,3,2,1,6,0
10411,"高雄市","路竹區下坑里",4,2,2,6,4,2,4,0
10411,"高雄市","路竹區新達里",1,1,0,1,1,0,2,0
10411,"高雄市","路竹區鴨寮里",1,1,0,3,3,0,6,0
10411,"高雄市","路竹區竹東里",9,5,4,3,1,2,2,1
10411,"高雄市","路竹區竹滬里",4,3,1,9,5,4,7,0
10411,"高雄市","路竹區竹南里",5,2,3,2,2,0,10,1
10411,"高雄市","路竹區竹西里",1,0,1,2,1,1,5,0
10411,"高雄市","路竹區竹園里",1,1,0,2,0,2,0,0
10411,"高雄市","茂林區多納里",1,0,1,0,0,0,0,0
10411,"高雄市","茂林區茂林里",2,2,0,3,1,2,1,1
10411,"高雄市","茂林區萬山里",1,0,1,0,0,0,0,0
10411,"高雄市","美濃區德興里",2,1,1,0,0,0,1,1
10411,"高雄市","美濃區東門里",0,0,0,5,2,3,1,1
10411,"高雄市","美濃區福安里",2,0,2,6,2,4,2,0
10411,"高雄市","美濃區廣德里",3,1,2,1,1,0,1,0
10411,"高雄市","美濃區廣林里",2,1,1,3,1,2,3,0
10411,"高雄市","美濃區合和里",2,1,1,5,3,2,1,2
10411,"高雄市","美濃區吉東里",2,1,1,5,2,3,1,0
10411,"高雄市","美濃區吉和里",3,2,1,3,1,2,3,0
10411,"高雄市","美濃區吉洋里",2,0,2,11,10,1,5,0
10411,"高雄市","美濃區龍肚里",3,1,2,3,2,1,0,1
10411,"高雄市","美濃區龍山里",1,0,1,6,5,1,1,0
10411,"高雄市","美濃區祿興里",4,3,1,3,2,1,7,2
10411,"高雄市","美濃區瀰濃里",5,3,2,3,1,2,2,0
10411,"高雄市","美濃區清水里",1,1,0,5,3,2,2,1
10411,"高雄市","美濃區獅山里",2,1,1,8,4,4,3,0
10411,"高雄市","美濃區泰安里",1,0,1,4,1,3,2,1
10411,"高雄市","美濃區興隆里",0,0,0,4,3,1,1,0
10411,"高雄市","美濃區中壇里",6,2,4,2,0,2,2,0
10411,"高雄市","美濃區中圳里",4,2,2,7,4,3,1,1
10411,"高雄市","彌陀區光和里",4,1,3,1,1,0,2,0
10411,"高雄市","彌陀區過港里",2,2,0,2,1,1,1,0
10411,"高雄市","彌陀區海尾里",3,1,2,1,0,1,1,0
10411,"高雄市","彌陀區舊港里",2,1,1,3,1,2,1,1
10411,"高雄市","彌陀區漯底里",1,0,1,1,1,0,2,1
10411,"高雄市","彌陀區彌靖里",2,1,1,8,3,5,1,0
10411,"高雄市","彌陀區彌仁里",0,0,0,0,0,0,1,1
10411,"高雄市","彌陀區彌壽里",1,0,1,0,0,0,0,0
10411,"高雄市","彌陀區彌陀里",3,1,2,2,2,0,5,0
10411,"高雄市","彌陀區南寮里",1,1,0,2,1,1,3,0
10411,"高雄市","彌陀區文安里",1,1,0,4,2,2,1,2
10411,"高雄市","彌陀區鹽埕里",3,2,1,6,3,3,3,2
10411,"高雄市","那瑪夏區達卡努瓦里",12,7,5,1,1,0,2,2
10411,"高雄市","那瑪夏區瑪雅里",2,0,2,0,0,0,1,0
10411,"高雄市","那瑪夏區南沙魯里",1,0,1,2,1,1,0,0
10411,"高雄市","楠梓區翠屏里",22,9,13,15,6,9,32,8
10411,"高雄市","楠梓區大昌里",2,1,1,8,6,2,6,1
10411,"高雄市","楠梓區東寧里",11,3,8,4,3,1,10,1
10411,"高雄市","楠梓區福昌里",0,0,0,3,2,1,2,0
10411,"高雄市","楠梓區廣昌里",3,2,1,11,9,2,0,1
10411,"高雄市","楠梓區國昌里",5,5,0,3,2,1,5,2
10411,"高雄市","楠梓區和昌里",2,1,1,4,3,1,2,1
10411,"高雄市","楠梓區宏昌里",7,4,3,1,1,0,6,2
10411,"高雄市","楠梓區宏南里",0,0,0,2,2,0,0,0
10411,"高雄市","楠梓區宏榮里",4,4,0,6,6,0,4,1
10411,"高雄市","楠梓區宏毅里",1,0,1,9,3,6,4,4
10411,"高雄市","楠梓區惠豐里",3,2,1,6,5,1,9,2
10411,"高雄市","楠梓區惠民里",5,1,4,8,5,3,7,4
10411,"高雄市","楠梓區惠楠里",4,3,1,4,2,2,6,1
10411,"高雄市","楠梓區加昌里",19,7,12,9,5,4,12,4
10411,"高雄市","楠梓區建昌里",4,4,0,3,2,1,1,1
10411,"高雄市","楠梓區金田里",4,3,1,7,4,3,4,1
10411,"高雄市","楠梓區錦屏里",4,0,4,6,5,1,4,2
10411,"高雄市","楠梓區久昌里",3,2,1,1,1,0,1,2
10411,"高雄市","楠梓區藍田里",18,13,5,5,1,4,18,2
10411,"高雄市","楠梓區隆昌里",6,3,3,3,2,1,2,0
10411,"高雄市","楠梓區清豐里",72,31,41,14,7,7,44,12
10411,"高雄市","楠梓區慶昌里",9,7,2,2,1,1,3,2
10411,"高雄市","楠梓區仁昌里",8,4,4,4,1,3,17,3
10411,"高雄市","楠梓區稔田里",3,1,2,2,0,2,3,0
10411,"高雄市","楠梓區瑞屏里",10,4,6,7,2,5,5,4
10411,"高雄市","楠梓區盛昌里",9,4,5,7,3,4,9,3
10411,"高雄市","楠梓區泰昌里",3,1,2,2,1,1,3,1
10411,"高雄市","楠梓區五常里",13,9,4,6,3,3,17,1
10411,"高雄市","楠梓區享平里",4,1,3,4,2,2,5,1
10411,"高雄市","楠梓區興昌里",12,7,5,9,4,5,10,2
10411,"高雄市","楠梓區秀昌里",5,3,2,5,2,3,1,0
10411,"高雄市","楠梓區玉屏里",5,1,4,7,3,4,4,1
10411,"高雄市","楠梓區裕昌里",9,5,4,3,2,1,10,2
10411,"高雄市","楠梓區中和里",5,3,2,0,0,0,4,0
10411,"高雄市","楠梓區中興里",3,3,0,2,2,0,1,1
10411,"高雄市","楠梓區中陽里",8,2,6,4,2,2,2,1
10411,"高雄市","內門區東埔里",1,0,1,1,0,1,1,0
10411,"高雄市","內門區溝坪里",1,1,0,3,1,2,0,0
10411,"高雄市","內門區觀亭里",2,0,2,5,3,2,3,1
10411,"高雄市","內門區光興里",2,1,1,3,2,1,0,0
10411,"高雄市","內門區金竹里",1,1,0,0,0,0,0,1
10411,"高雄市","內門區木柵里",2,1,1,1,0,1,2,1
10411,"高雄市","內門區內東里",2,1,1,2,1,1,0,0
10411,"高雄市","內門區內豊里",0,0,0,5,4,1,1,0
10411,"高雄市","內門區內門里",1,1,0,2,0,2,1,0
10411,"高雄市","內門區內南里",1,1,0,0,0,0,0,0
10411,"高雄市","內門區內興里",4,2,2,1,1,0,1,0
10411,"高雄市","內門區瑞山里",0,0,0,0,0,0,0,0
10411,"高雄市","內門區三平里",1,1,0,3,1,2,1,1
10411,"高雄市","內門區石坑里",0,0,0,1,1,0,0,0
10411,"高雄市","內門區永富里",0,0,0,2,1,1,2,0
10411,"高雄市","內門區永吉里",1,1,0,1,0,1,0,0
10411,"高雄市","內門區永興里",1,0,1,2,2,0,0,0
10411,"高雄市","內門區中埔里",1,0,1,0,0,0,0,0
10411,"高雄市","鳥松區大華里",14,10,4,8,5,3,9,5
10411,"高雄市","鳥松區大竹里",2,1,1,0,0,0,0,0
10411,"高雄市","鳥松區坔埔里",9,4,5,4,1,3,8,5
10411,"高雄市","鳥松區華美里",10,7,3,5,4,1,9,4
10411,"高雄市","鳥松區夢裡里",8,1,7,4,2,2,9,5
10411,"高雄市","鳥松區鳥松里",32,15,17,13,10,3,16,3
10411,"高雄市","鳥松區仁美里",9,5,4,11,6,5,12,1
10411,"高雄市","旗津區安順里",1,1,0,1,1,0,3,0
10411,"高雄市","旗津區北汕里",6,5,1,4,2,2,6,0
10411,"高雄市","旗津區慈愛里",3,0,3,3,2,1,1,2
10411,"高雄市","旗津區復興里",3,2,1,2,1,1,4,1
10411,"高雄市","旗津區南汕里",1,1,0,0,0,0,4,2
10411,"高雄市","旗津區旗下里",3,1,2,3,2,1,1,0
10411,"高雄市","旗津區上竹里",8,8,0,11,7,4,4,1
10411,"高雄市","旗津區實踐里",1,0,1,2,0,2,3,0
10411,"高雄市","旗津區永安里",4,2,2,5,4,1,0,1
10411,"高雄市","旗津區振興里",3,1,2,9,8,1,2,0
10411,"高雄市","旗津區中華里",4,1,3,3,3,0,3,0
10411,"高雄市","旗津區中興里",8,4,4,2,1,1,4,1
10411,"高雄市","旗津區中洲里",2,2,0,3,1,2,0,1
10411,"高雄市","旗山區大德里",4,3,1,5,5,0,1,0
10411,"高雄市","旗山區大林里",1,1,0,4,2,2,3,0
10411,"高雄市","旗山區大山里",0,0,0,5,3,2,2,1
10411,"高雄市","旗山區東昌里",1,0,1,2,1,1,2,1
10411,"高雄市","旗山區東平里",3,1,2,4,3,1,3,1
10411,"高雄市","旗山區廣福里",0,0,0,1,0,1,1,0
10411,"高雄市","旗山區鯤洲里",1,1,0,5,2,3,2,0
10411,"高雄市","旗山區湄洲里",2,0,2,2,1,1,0,1
10411,"高雄市","旗山區南勝里",3,2,1,5,3,2,2,4
10411,"高雄市","旗山區南洲里",2,1,1,3,3,0,3,0
10411,"高雄市","旗山區瑞吉里",2,2,0,3,1,2,5,0
10411,"高雄市","旗山區三協里",5,3,2,8,7,1,3,0
10411,"高雄市","旗山區上洲里",0,0,0,2,1,1,1,0
10411,"高雄市","旗山區太平里",3,2,1,5,3,2,1,2
10411,"高雄市","旗山區新光里",1,1,0,3,2,1,0,0
10411,"高雄市","旗山區永和里",10,5,5,6,3,3,3,1
10411,"高雄市","旗山區圓富里",3,2,1,3,1,2,3,0
10411,"高雄市","旗山區中寮里",0,0,0,2,2,0,0,0
10411,"高雄市","旗山區中正里",3,3,0,4,3,1,3,0
10411,"高雄市","旗山區中洲里",3,3,0,4,2,2,0,0
10411,"高雄市","旗山區竹峰里",2,1,1,3,2,1,2,0
10411,"高雄市","前金區北金里",0,0,0,0,0,0,0,0
10411,"高雄市","前金區博孝里",0,0,0,2,2,0,1,1
10411,"高雄市","前金區草江里",1,1,0,4,2,2,0,0
10411,"高雄市","前金區東金里",0,0,0,1,1,0,0,0
10411,"高雄市","前金區復元里",1,1,0,1,0,1,0,1
10411,"高雄市","前金區國民里",1,0,1,4,3,1,0,0
10411,"高雄市","前金區後金里",1,1,0,2,2,0,0,1
10411,"高雄市","前金區林投里",1,1,0,4,3,1,0,1
10411,"高雄市","前金區民生里",3,1,2,0,0,0,0,0
10411,"高雄市","前金區青山里",0,0,0,3,1,2,2,0
10411,"高雄市","前金區榮復里",1,1,0,3,1,2,1,1
10411,"高雄市","前金區三川里",1,1,0,2,1,1,2,1
10411,"高雄市","前金區社東里",2,1,1,2,2,0,1,0
10411,"高雄市","前金區社西里",1,1,0,2,2,0,0,1
10411,"高雄市","前金區文東里",0,0,0,2,1,1,0,0
10411,"高雄市","前金區文西里",1,0,1,1,1,0,2,0
10411,"高雄市","前金區新生里",8,4,4,2,2,0,1,4
10411,"高雄市","前金區長城里",1,1,0,1,0,1,2,0
10411,"高雄市","前金區長生里",2,1,1,6,3,3,3,1
10411,"高雄市","前金區長興里",2,1,1,0,0,0,3,3
10411,"高雄市","前鎮區草衙里",14,10,4,15,10,5,11,6
10411,"高雄市","前鎮區德昌里",2,2,0,4,2,2,2,1
10411,"高雄市","前鎮區復國里",0,0,0,8,5,3,3,0
10411,"高雄市","前鎮區建隆里",1,0,1,2,1,1,0,0
10411,"高雄市","前鎮區良和里",5,4,1,3,2,1,3,2
10411,"高雄市","前鎮區民權里",3,0,3,1,0,1,2,2
10411,"高雄市","前鎮區明道里",0,0,0,3,2,1,1,0
10411,"高雄市","前鎮區明禮里",2,1,1,4,1,3,1,0
10411,"高雄市","前鎮區明孝里",2,1,1,2,1,1,1,1
10411,"高雄市","前鎮區明義里",4,3,1,4,4,0,1,1
10411,"高雄市","前鎮區明正里",8,5,3,13,8,5,5,2
10411,"高雄市","前鎮區平昌里",1,1,0,4,2,2,1,0
10411,"高雄市","前鎮區平等里",5,2,3,8,3,5,5,1
10411,"高雄市","前鎮區前鎮里",3,1,2,2,1,1,1,0
10411,"高雄市","前鎮區仁愛里",0,0,0,3,3,0,3,3
10411,"高雄市","前鎮區瑞北里",3,1,2,6,5,1,4,1
10411,"高雄市","前鎮區瑞昌里",7,5,2,9,7,2,7,1
10411,"高雄市","前鎮區瑞誠里",3,2,1,3,3,0,2,0
10411,"高雄市","前鎮區瑞東里",2,1,1,5,2,3,0,1
10411,"高雄市","前鎮區瑞豐里",7,4,3,2,0,2,5,1
10411,"高雄市","前鎮區瑞崗里",6,3,3,5,4,1,3,2
10411,"高雄市","前鎮區瑞和里",1,1,0,6,3,3,2,2
10411,"高雄市","前鎮區瑞華里",9,4,5,7,4,3,6,1
10411,"高雄市","前鎮區瑞隆里",6,2,4,2,1,1,6,1
10411,"高雄市","前鎮區瑞南里",14,7,7,7,4,3,7,1
10411,"高雄市","前鎮區瑞平里",7,2,5,5,2,3,6,3
10411,"高雄市","前鎮區瑞文里",0,0,0,3,3,0,3,1
10411,"高雄市","前鎮區瑞西里",1,0,1,3,2,1,2,0
10411,"高雄市","前鎮區瑞祥里",4,2,2,6,6,0,4,0
10411,"高雄市","前鎮區瑞興里",6,5,1,6,3,3,4,0
10411,"高雄市","前鎮區瑞竹里",5,3,2,3,1,2,1,1
10411,"高雄市","前鎮區盛豐里",4,2,2,5,3,2,6,3
10411,"高雄市","前鎮區盛興里",6,3,3,3,2,1,2,1
10411,"高雄市","前鎮區西甲里",1,0,1,2,2,0,4,1
10411,"高雄市","前鎮區西山里",4,1,3,3,2,1,4,2
10411,"高雄市","前鎮區信德里",3,3,0,5,3,2,3,2
10411,"高雄市","前鎮區信義里",2,1,1,1,1,0,1,1
10411,"高雄市","前鎮區興邦里",5,3,2,3,0,3,7,2
10411,"高雄市","前鎮區興東里",9,3,6,6,3,3,8,1
10411,"高雄市","前鎮區興化里",1,1,0,2,1,1,2,0
10411,"高雄市","前鎮區興仁里",0,0,0,3,2,1,0,0
10411,"高雄市","前鎮區興中里",8,1,7,6,5,1,5,1
10411,"高雄市","前鎮區振興里",2,1,1,4,1,3,1,2
10411,"高雄市","前鎮區鎮北里",0,0,0,5,4,1,1,2
10411,"高雄市","前鎮區鎮昌里",1,1,0,6,4,2,3,2
10411,"高雄市","前鎮區鎮東里",2,1,1,6,4,2,1,1
10411,"高雄市","前鎮區鎮海里",8,4,4,5,2,3,5,1
10411,"高雄市","前鎮區鎮榮里",3,2,1,4,2,2,6,3
10411,"高雄市","前鎮區鎮陽里",2,2,0,2,1,1,0,3
10411,"高雄市","前鎮區鎮中里",2,1,1,3,2,1,1,0
10411,"高雄市","前鎮區忠誠里",3,0,3,6,5,1,5,0
10411,"高雄市","前鎮區忠純里",8,2,6,20,13,7,9,4
10411,"高雄市","前鎮區忠孝里",6,2,4,0,0,0,5,1
10411,"高雄市","前鎮區竹北里",3,1,2,1,1,0,3,1
10411,"高雄市","前鎮區竹東里",4,2,2,5,2,3,1,0
10411,"高雄市","前鎮區竹南里",21,13,8,8,6,2,11,2
10411,"高雄市","前鎮區竹內里",3,3,0,3,2,1,3,0
10411,"高雄市","前鎮區竹西里",9,3,6,7,6,1,9,1
10411,"高雄市","前鎮區竹中里",7,5,2,3,0,3,3,2
10411,"高雄市","橋頭區白樹里",8,3,5,2,0,2,5,1
10411,"高雄市","橋頭區筆秀里",3,2,1,2,0,2,4,0
10411,"高雄市","橋頭區德松里",1,1,0,3,3,0,1,0
10411,"高雄市","橋頭區頂鹽里",1,0,1,2,1,1,4,0
10411,"高雄市","橋頭區東林里",6,2,4,7,3,4,4,2
10411,"高雄市","橋頭區甲北里",6,3,3,5,2,3,4,2
10411,"高雄市","橋頭區甲南里",2,2,0,3,2,1,4,0
10411,"高雄市","橋頭區橋南里",1,0,1,3,3,0,2,1
10411,"高雄市","橋頭區橋頭里",5,2,3,2,2,0,1,0
10411,"高雄市","橋頭區三德里",3,1,2,0,0,0,0,1
10411,"高雄市","橋頭區仕豐里",7,4,3,5,2,3,7,4
10411,"高雄市","橋頭區仕和里",10,6,4,5,4,1,9,1
10411,"高雄市","橋頭區仕隆里",5,4,1,4,3,1,2,1
10411,"高雄市","橋頭區西林里",1,1,0,4,3,1,0,1
10411,"高雄市","橋頭區新莊里",4,1,3,1,1,0,3,2
10411,"高雄市","橋頭區芋寮里",1,0,1,3,2,1,2,1
10411,"高雄市","橋頭區中崎里",0,0,0,0,0,0,1,1
10411,"高雄市","仁武區八卦里",31,17,14,13,9,4,41,10
10411,"高雄市","仁武區赤山里",18,9,9,3,1,2,8,1
10411,"高雄市","仁武區大灣里",3,2,1,3,1,2,9,4
10411,"高雄市","仁武區高楠里",6,3,3,2,1,1,4,0
10411,"高雄市","仁武區後安里",4,2,2,2,1,1,3,2
10411,"高雄市","仁武區考潭里",2,2,0,3,2,1,1,1
10411,"高雄市","仁武區仁慈里",7,5,2,1,1,0,2,2
10411,"高雄市","仁武區仁福里",0,0,0,1,0,1,1,1
10411,"高雄市","仁武區仁和里",10,5,5,3,2,1,6,3
10411,"高雄市","仁武區仁武里",12,10,2,12,8,4,14,2
10411,"高雄市","仁武區灣內里",21,10,11,6,4,2,14,5
10411,"高雄市","仁武區文武里",28,14,14,12,7,5,22,7
10411,"高雄市","仁武區烏林里",5,3,2,7,5,2,7,2
10411,"高雄市","仁武區五和里",11,5,6,6,3,3,7,2
10411,"高雄市","仁武區中華里",3,1,2,2,2,0,10,1
10411,"高雄市","仁武區竹後里",4,2,2,2,1,1,4,0
10411,"高雄市","三民區安邦里",5,3,2,9,7,2,5,0
10411,"高雄市","三民區安東里",2,1,1,4,2,2,1,1
10411,"高雄市","三民區安發里",3,1,2,7,4,3,6,1
10411,"高雄市","三民區安和里",3,3,0,3,2,1,3,1
10411,"高雄市","三民區安吉里",10,10,0,5,4,1,10,4
10411,"高雄市","三民區安康里",1,0,1,6,3,3,2,0
10411,"高雄市","三民區安寧里",2,0,2,5,3,2,3,0
10411,"高雄市","三民區安生里",4,4,0,4,2,2,2,0
10411,"高雄市","三民區安泰里",6,2,4,5,4,1,7,1
10411,"高雄市","三民區安宜里",7,3,4,6,3,3,4,1
10411,"高雄市","三民區寶安里",4,2,2,3,3,0,10,1
10411,"高雄市","三民區寶德里",10,5,5,9,5,4,9,2
10411,"高雄市","三民區寶國里",18,8,10,7,5,2,9,3
10411,"高雄市","三民區寶華里",4,1,3,6,2,4,5,3
10411,"高雄市","三民區寶龍里",2,1,1,7,4,3,6,0
10411,"高雄市","三民區寶民里",8,5,3,6,2,4,6,1
10411,"高雄市","三民區寶慶里",5,1,4,1,0,1,2,2
10411,"高雄市","三民區寶盛里",11,8,3,4,2,2,8,2
10411,"高雄市","三民區寶獅里",4,2,2,1,1,0,7,2
10411,"高雄市","三民區寶泰里",8,4,4,3,3,0,8,0
10411,"高雄市","三民區寶興里",7,3,4,6,5,1,13,2
10411,"高雄市","三民區寶業里",18,6,12,7,4,3,10,0
10411,"高雄市","三民區寶玉里",17,11,6,14,9,5,8,4
10411,"高雄市","三民區寶中里",7,6,1,5,2,3,6,3
10411,"高雄市","三民區寶珠里",14,8,6,6,4,2,7,2
10411,"高雄市","三民區本安里",8,3,5,5,3,2,7,0
10411,"高雄市","三民區本館里",13,7,6,12,3,9,17,3
10411,"高雄市","三民區本和里",14,6,8,7,2,5,13,3
10411,"高雄市","三民區本上里",7,5,2,3,3,0,5,2
10411,"高雄市","三民區本文里",1,1,0,1,0,1,6,0
10411,"高雄市","三民區本武里",2,1,1,8,3,5,4,0
10411,"高雄市","三民區本揚里",10,5,5,4,3,1,10,6
10411,"高雄市","三民區本元里",10,7,3,3,3,0,5,2
10411,"高雄市","三民區博愛里",3,1,2,5,3,2,0,2
10411,"高雄市","三民區博惠里",5,3,2,7,5,2,3,2
10411,"高雄市","三民區川東里",1,1,0,4,3,1,0,0
10411,"高雄市","三民區達德里",1,1,0,1,0,1,1,1
10411,"高雄市","三民區達明里",4,2,2,2,1,1,1,1
10411,"高雄市","三民區達仁里",3,2,1,3,2,1,3,3
10411,"高雄市","三民區達勇里",1,1,0,0,0,0,0,1
10411,"高雄市","三民區德北里",3,1,2,2,1,1,2,1
10411,"高雄市","三民區德東里",1,1,0,2,0,2,2,0
10411,"高雄市","三民區德仁里",5,2,3,1,1,0,2,2
10411,"高雄市","三民區德西里",0,0,0,0,0,0,0,1
10411,"高雄市","三民區德行里",1,1,0,3,2,1,5,0
10411,"高雄市","三民區德智里",5,3,2,5,4,1,6,2
10411,"高雄市","三民區鼎金里",9,5,4,4,4,0,8,3
10411,"高雄市","三民區鼎力里",5,3,2,4,4,0,4,1
10411,"高雄市","三民區鼎強里",11,5,6,4,1,3,7,3
10411,"高雄市","三民區鼎盛里",14,9,5,9,2,7,13,4
10411,"高雄市","三民區鼎泰里",38,15,23,24,14,10,23,8
10411,"高雄市","三民區鼎西里",20,10,10,11,7,4,18,1
10411,"高雄市","三民區鼎中里",7,6,1,6,5,1,2,2
10411,"高雄市","三民區豐裕里",1,1,0,2,1,1,2,2
10411,"高雄市","三民區鳳北里",0,0,0,5,5,0,1,0
10411,"高雄市","三民區鳳南里",0,0,0,3,2,1,2,0
10411,"高雄市","三民區港東里",0,0,0,3,1,2,1,0
10411,"高雄市","三民區港西里",0,0,0,3,2,1,1,1
10411,"高雄市","三民區港新里",4,1,3,6,3,3,1,0
10411,"高雄市","三民區建東里",3,2,1,1,1,0,3,1
10411,"高雄市","三民區精華里",2,2,0,2,2,0,0,0
10411,"高雄市","三民區力行里",1,0,1,2,1,1,3,0
10411,"高雄市","三民區立誠里",0,0,0,1,1,0,0,0
10411,"高雄市","三民區立德里",4,0,4,3,3,0,2,0
10411,"高雄市","三民區立業里",2,2,0,1,0,1,0,0
10411,"高雄市","三民區民享里",5,5,0,2,2,0,3,0
10411,"高雄市","三民區千北里",1,1,0,7,3,4,2,0
10411,"高雄市","三民區千秋里",3,0,3,3,2,1,2,0
10411,"高雄市","三民區千歲里",2,1,1,2,0,2,2,1
10411,"高雄市","三民區十美里",0,0,0,1,1,0,0,0
10411,"高雄市","三民區十全里",0,0,0,1,1,0,4,1
10411,"高雄市","三民區同德里",1,1,0,9,5,4,7,2
10411,"高雄市","三民區灣愛里",3,1,2,8,2,6,5,2
10411,"高雄市","三民區灣成里",5,3,2,2,2,0,1,2
10411,"高雄市","三民區灣復里",7,4,3,1,1,0,6,2
10411,"高雄市","三民區灣華里",4,2,2,6,3,3,3,2
10411,"高雄市","三民區灣利里",4,2,2,2,1,1,5,2
10411,"高雄市","三民區灣勝里",4,1,3,3,2,1,5,2
10411,"高雄市","三民區灣興里",7,4,3,3,1,2,3,1
10411,"高雄市","三民區灣中里",10,5,5,8,4,4,8,2
10411,"高雄市","三民區灣子里",7,3,4,2,2,0,5,0
10411,"高雄市","三民區興德里",3,0,3,3,3,0,0,2
10411,"高雄市","三民區裕民里",3,0,3,3,2,1,3,0
10411,"高雄市","三民區長明里",2,2,0,3,2,1,0,0
10411,"高雄市","三民區正順里",9,7,2,4,2,2,8,1
10411,"高雄市","三民區正興里",22,12,10,16,7,9,18,2
10411,"高雄市","杉林區大愛里",3,2,1,3,3,0,1,1
10411,"高雄市","杉林區集來里",0,0,0,7,5,2,0,0
10411,"高雄市","杉林區木梓里",0,0,0,0,0,0,0,0
10411,"高雄市","杉林區杉林里",0,0,0,2,1,1,0,0
10411,"高雄市","杉林區上平里",1,1,0,4,2,2,0,0
10411,"高雄市","杉林區新庄里",2,1,1,4,2,2,0,1
10411,"高雄市","杉林區月眉里",2,2,0,1,1,0,4,0
10411,"高雄市","杉林區月美里",1,0,1,6,5,1,0,1
10411,"高雄市","桃源區寶山里",1,1,0,0,0,0,2,0
10411,"高雄市","桃源區復興里",2,0,2,1,0,1,0,0
10411,"高雄市","桃源區高中里",3,1,2,2,0,2,1,0
10411,"高雄市","桃源區建山里",1,1,0,0,0,0,2,0
10411,"高雄市","桃源區拉芙蘭里",0,0,0,1,1,0,1,0
10411,"高雄市","桃源區梅山里",2,1,1,0,0,0,1,0
10411,"高雄市","桃源區勤和里",0,0,0,0,0,0,0,1
10411,"高雄市","桃源區桃源里",3,3,0,0,0,0,2,0
10411,"高雄市","田寮區崇德里",3,1,2,5,1,4,1,0
10411,"高雄市","田寮區大同里",0,0,0,1,1,0,0,0
10411,"高雄市","田寮區古亭里",1,0,1,2,1,1,0,0
10411,"高雄市","田寮區鹿埔里",0,0,0,0,0,0,1,0
10411,"高雄市","田寮區南安里",1,1,0,5,2,3,0,0
10411,"高雄市","田寮區七星里",1,1,0,2,1,1,0,1
10411,"高雄市","田寮區三和里",0,0,0,0,0,0,0,0
10411,"高雄市","田寮區田寮里",0,0,0,1,1,0,0,0
10411,"高雄市","田寮區西德里",0,0,0,0,0,0,0,2
10411,"高雄市","田寮區新興里",3,0,3,3,2,1,1,0
10411,"高雄市","小港區大苓里",3,0,3,6,5,1,1,1
10411,"高雄市","小港區大坪里",5,2,3,2,2,0,3,1
10411,"高雄市","小港區店鎮里",15,6,9,7,7,0,13,4
10411,"高雄市","小港區二苓里",5,2,3,5,3,2,6,5
10411,"高雄市","小港區鳳宮里",2,2,0,4,1,3,7,2
10411,"高雄市","小港區鳳林里",9,2,7,3,2,1,2,1
10411,"高雄市","小港區鳳鳴里",6,3,3,3,2,1,7,2
10411,"高雄市","小港區鳳森里",2,2,0,6,2,4,3,2
10411,"高雄市","小港區鳳興里",6,1,5,3,0,3,2,1
10411,"高雄市","小港區鳳源里",7,5,2,3,3,0,9,3
10411,"高雄市","小港區港后里",7,2,5,4,2,2,7,2
10411,"高雄市","小港區港口里",6,4,2,5,3,2,2,1
10411,"高雄市","小港區港明里",12,3,9,6,2,4,8,2
10411,"高雄市","小港區港南里",3,1,2,2,2,0,0,0
10411,"高雄市","小港區港墘里",6,3,3,2,2,0,1,2
10411,"高雄市","小港區港興里",5,3,2,4,4,0,4,0
10411,"高雄市","小港區港正里",5,1,4,6,4,2,0,3
10411,"高雄市","小港區高松里",11,5,6,4,2,2,7,3
10411,"高雄市","小港區桂林里",12,7,5,8,3,5,15,7
10411,"高雄市","小港區合作里",8,4,4,6,5,1,3,2
10411,"高雄市","小港區宏亮里",10,7,3,8,4,4,2,1
10411,"高雄市","小港區濟南里",10,7,3,2,1,1,5,4
10411,"高雄市","小港區孔宅里",13,5,8,8,5,3,6,1
10411,"高雄市","小港區六苓里",7,3,4,1,1,0,5,2
10411,"高雄市","小港區龍鳳里",8,4,4,9,6,3,4,2
10411,"高雄市","小港區坪頂里",16,4,12,3,3,0,11,2
10411,"高雄市","小港區青島里",0,0,0,7,3,4,4,1
10411,"高雄市","小港區三苓里",5,3,2,1,0,1,6,2
10411,"高雄市","小港區廈莊里",13,5,8,3,1,2,10,0
10411,"高雄市","小港區山東里",2,1,1,3,3,0,5,1
10411,"高雄市","小港區山明里",25,13,12,18,6,12,30,3
10411,"高雄市","小港區順苓里",6,4,2,9,6,3,7,3
10411,"高雄市","小港區松金里",7,4,3,4,1,3,8,0
10411,"高雄市","小港區松山里",10,5,5,0,0,0,4,2
10411,"高雄市","小港區泰山里",9,3,6,5,3,2,5,2
10411,"高雄市","小港區小港里",1,1,0,3,2,1,3,2
10411,"高雄市","小港區正苓里",5,3,2,3,2,1,7,5
10411,"高雄市","小港區中厝里",5,2,3,1,1,0,5,2
10411,"高雄市","新興區愛平里",4,1,3,3,1,2,2,1
10411,"高雄市","新興區成功里",0,0,0,0,0,0,2,0
10411,"高雄市","新興區大明里",0,0,0,1,1,0,0,2
10411,"高雄市","新興區德生里",3,2,1,1,0,1,5,2
10411,"高雄市","新興區德望里",0,0,0,4,1,3,2,0
10411,"高雄市","新興區德政里",0,0,0,1,0,1,1,0
10411,"高雄市","新興區東坡里",2,2,0,4,2,2,2,0
10411,"高雄市","新興區光耀里",0,0,0,6,4,2,4,1
10411,"高雄市","新興區漢民里",1,1,0,0,0,0,2,2
10411,"高雄市","新興區浩然里",2,1,1,4,2,2,1,1
10411,"高雄市","新興區華聲里",0,0,0,1,1,0,1,0
10411,"高雄市","新興區建華里",1,0,1,5,2,3,1,1
10411,"高雄市","新興區建興里",1,0,1,2,1,1,3,0
10411,"高雄市","新興區蕉園里",0,0,0,2,0,2,4,0
10411,"高雄市","新興區開平里",5,4,1,3,2,1,3,2
10411,"高雄市","新興區黎明里",0,0,0,0,0,0,2,1
10411,"高雄市","新興區明莊里",1,1,0,1,1,0,0,1
10411,"高雄市","新興區南港里",2,1,1,2,2,0,3,0
10411,"高雄市","新興區秋山里",3,2,1,1,1,0,2,0
10411,"高雄市","新興區仁聲里",2,2,0,3,1,2,2,0
10411,"高雄市","新興區榮治里",0,0,0,1,0,1,0,0
10411,"高雄市","新興區順昌里",2,1,1,2,0,2,1,0
10411,"高雄市","新興區文昌里",5,3,2,3,1,2,7,3
10411,"高雄市","新興區新江里",1,0,1,3,2,1,3,0
10411,"高雄市","新興區興昌里",4,1,3,3,0,3,1,0
10411,"高雄市","新興區永寧里",3,3,0,1,0,1,0,0
10411,"高雄市","新興區玉衡里",1,1,0,3,1,2,3,0
10411,"高雄市","新興區長驛里",2,1,1,1,0,1,1,0
10411,"高雄市","新興區振成里",0,0,0,1,1,0,2,0
10411,"高雄市","新興區振華里",1,0,1,0,0,0,1,1
10411,"高雄市","新興區正氣里",2,2,0,2,2,0,1,1
10411,"高雄市","新興區中東里",0,0,0,5,1,4,2,2
10411,"高雄市","鹽埕區博愛里",0,0,0,3,0,3,3,0
10411,"高雄市","鹽埕區慈愛里",0,0,0,0,0,0,0,0
10411,"高雄市","鹽埕區府北里",1,1,0,7,6,1,0,2
10411,"高雄市","鹽埕區港都里",2,2,0,1,1,0,2,0
10411,"高雄市","鹽埕區光明里",4,2,2,1,1,0,3,0
10411,"高雄市","鹽埕區河濱里",2,1,1,4,4,0,5,1
10411,"高雄市","鹽埕區江南里",0,0,0,1,1,0,0,0
10411,"高雄市","鹽埕區江西里",1,0,1,2,0,2,1,0
10411,"高雄市","鹽埕區教仁里",4,2,2,3,3,0,1,2
10411,"高雄市","鹽埕區瀨南里",1,1,0,0,0,0,2,0
10411,"高雄市","鹽埕區藍橋里",3,0,3,0,0,0,1,1
10411,"高雄市","鹽埕區陸橋里",2,1,1,2,0,2,1,1
10411,"高雄市","鹽埕區南端里",0,0,0,4,2,2,2,0
10411,"高雄市","鹽埕區沙地里",1,0,1,1,0,1,0,1
10411,"高雄市","鹽埕區壽星里",1,1,0,2,1,1,1,2
10411,"高雄市","鹽埕區新豐里",0,0,0,3,2,1,3,0
10411,"高雄市","鹽埕區新化里",1,0,1,0,0,0,1,0
10411,"高雄市","鹽埕區新樂里",0,0,0,2,0,2,2,0
10411,"高雄市","鹽埕區育仁里",2,0,2,1,1,0,0,0
10411,"高雄市","鹽埕區中山里",0,0,0,1,1,0,1,0
10411,"高雄市","鹽埕區中原里",1,0,1,3,1,2,0,1
10411,"高雄市","燕巢區安招里",3,2,1,18,14,4,9,1
10411,"高雄市","燕巢區東燕里",2,1,1,4,2,2,6,1
10411,"高雄市","燕巢區鳳雄里",2,0,2,3,1,2,1,0
10411,"高雄市","燕巢區橫山里",0,0,0,1,1,0,1,0
10411,"高雄市","燕巢區尖山里",0,0,0,3,1,2,1,1
10411,"高雄市","燕巢區角宿里",5,3,2,3,3,0,6,0
10411,"高雄市","燕巢區金山里",0,0,0,1,0,1,0,0
10411,"高雄市","燕巢區南燕里",3,2,1,5,4,1,5,2
10411,"高雄市","燕巢區瓊林里",2,1,1,7,5,2,4,0
10411,"高雄市","燕巢區深水里",3,2,1,4,2,2,4,1
10411,"高雄市","燕巢區西燕里",5,3,2,4,3,1,3,2
10411,"高雄市","永安區保寧里",11,7,4,4,4,0,5,1
10411,"高雄市","永安區維新里",6,2,4,6,5,1,5,0
10411,"高雄市","永安區新港里",10,6,4,3,2,1,1,1
10411,"高雄市","永安區鹽田里",1,1,0,2,1,1,0,0
10411,"高雄市","永安區永安里",4,3,1,5,3,2,4,0
10411,"高雄市","永安區永華里",2,2,0,4,2,2,2,1
10411,"高雄市","梓官區赤東里",3,3,0,2,2,0,4,1
10411,"高雄市","梓官區赤崁里",2,1,1,3,1,2,5,1
10411,"高雄市","梓官區赤西里",3,1,2,2,1,1,2,0
10411,"高雄市","梓官區大舍里",9,4,5,5,2,3,8,2
10411,"高雄市","梓官區典寶里",1,0,1,3,2,1,5,1
10411,"高雄市","梓官區茄苳里",3,1,2,3,2,1,6,0
10411,"高雄市","梓官區禮蚵里",7,4,3,6,2,4,2,1
10411,"高雄市","梓官區同安里",1,0,1,5,4,1,4,0
10411,"高雄市","梓官區信蚵里",2,1,1,1,1,0,5,3
10411,"高雄市","梓官區智蚵里",7,5,2,6,2,4,6,0
10411,"高雄市","梓官區中崙里",1,1,0,2,2,0,1,0
10411,"高雄市","梓官區梓和里",4,1,3,8,6,2,1,0
10411,"高雄市","梓官區梓平里",5,4,1,4,2,2,1,1
10411,"高雄市","梓官區梓信里",3,2,1,1,1,0,3,1
10411,"高雄市","梓官區梓義里",2,2,0,3,2,1,3,0
10411,"高雄市","左營區菜公里",52,23,29,20,13,7,32,16
10411,"高雄市","左營區城南里",0,0,0,1,1,0,0,0
10411,"高雄市","左營區崇實里",8,3,5,2,1,1,10,2
10411,"高雄市","左營區頂北里",0,0,0,0,0,0,2,0
10411,"高雄市","左營區頂西里",1,0,1,0,0,0,2,1
10411,"高雄市","左營區福山里",75,45,30,31,15,16,52,28
10411,"高雄市","左營區光輝里",2,2,0,3,1,2,3,0
10411,"高雄市","左營區果峰里",0,0,0,3,0,3,4,0
10411,"高雄市","左營區果惠里",2,1,1,3,2,1,2,0
10411,"高雄市","左營區果貿里",6,2,4,8,5,3,5,1
10411,"高雄市","左營區海勝里",4,2,2,14,9,5,8,8
10411,"高雄市","左營區合群里",1,0,1,11,9,2,2,0
10411,"高雄市","左營區進學里",2,2,0,11,9,2,1,1
10411,"高雄市","左營區莒光里",4,2,2,1,0,1,1,1
10411,"高雄市","左營區路東里",0,0,0,4,1,3,0,1
10411,"高雄市","左營區廟北里",0,0,0,0,0,0,3,1
10411,"高雄市","左營區廟東里",1,0,1,0,0,0,0,0
10411,"高雄市","左營區明建里",3,1,2,0,0,0,2,2
10411,"高雄市","左營區埤北里",0,0,0,8,7,1,1,0
10411,"高雄市","左營區埤東里",2,2,0,3,2,1,0,0
10411,"高雄市","左營區埤西里",0,0,0,0,0,0,1,1
10411,"高雄市","左營區屏山里",1,1,0,3,3,0,1,0
10411,"高雄市","左營區廍北里",0,0,0,1,1,0,1,0
10411,"高雄市","左營區廍南里",0,0,0,2,0,2,1,0
10411,"高雄市","左營區聖后里",4,3,1,0,0,0,1,0
10411,"高雄市","左營區聖南里",1,1,0,1,1,0,0,0
10411,"高雄市","左營區聖西里",0,0,0,1,1,0,0,0
10411,"高雄市","左營區尾北里",5,3,2,3,2,1,4,0
10411,"高雄市","左營區尾南里",1,1,0,2,2,0,1,1
10411,"高雄市","左營區尾西里",1,0,1,3,2,1,1,2
10411,"高雄市","左營區祥和里",0,0,0,6,6,0,0,0
10411,"高雄市","左營區新光里",25,13,12,12,9,3,21,5
10411,"高雄市","左營區新上里",56,23,33,28,15,13,41,13
10411,"高雄市","左營區新下里",18,12,6,13,10,3,20,9
10411,"高雄市","左營區新中里",9,5,4,6,4,2,11,3
10411,"高雄市","左營區永清里",5,5,0,2,2,0,1,1
10411,"高雄市","左營區中北里",0,0,0,0,0,0,1,0
10411,"高雄市","左營區中南里",0,0,0,3,3,0,0,1
10411,"高雄市","左營區自助里",0,0,0,0,0,0,0,0
